FECHA;PROVINCIA;AMBITO;CATEGORIA;TEST_REALIZADOS;TEST_POSITIVO;AISLAMIENTO;ALTA;codigo_ine
2020-04-05;Ávila;Todos;Médicos;139;63;60;3;5019
2020-04-05;Ávila;Todos;Otros sanitarios;8;5;5;0;5019
2020-04-05;Burgos;Todos;Administrativo;16;5;5;0;9059
2020-04-05;Burgos;Todos;Otros sanitarios;2;0;0;0;9059
2020-04-05;Burgos;Todos;Personal en formación;15;4;3;1;9059
2020-04-05;Burgos;Todos;Servicios de apoyo no sanitario;3;1;0;1;9059
2020-04-05;Burgos;Todos;Técnicos sanitarios;10;4;2;2;9059
2020-04-05;León;Todos;Técnicos sanitarios;14;6;5;1;24089
2020-04-05;Palencia;Todos;Administrativo;7;3;3;0;34120
2020-04-05;Palencia;Todos;Auxiliares sanitarios;25;8;7;1;34120
2020-04-05;Palencia;Todos;Celador;15;9;8;1;34120
2020-04-05;Palencia;Todos;Servicios de apoyo no sanitario;3;2;2;0;34120
2020-04-05;Palencia;Todos;Técnicos sanitarios;2;1;1;0;34120
2020-04-05;Salamanca;Todos;Administrativo;27;13;12;1;37274
2020-04-05;Salamanca;Todos;Auxiliares sanitarios;109;46;45;1;37274
2020-04-05;Salamanca;Todos;Médicos;257;98;77;21;37274
2020-04-05;Salamanca;Todos;Otros;1;1;1;0;37274
2020-04-05;Salamanca;Todos;Otros sanitarios;4;3;3;0;37274
2020-04-05;Salamanca;Todos;Servicios de apoyo no sanitario;22;11;9;2;37274
2020-04-05;Segovia;Todos;Auxiliares sanitarios;72;37;37;0;40004
2020-04-05;Segovia;Todos;Fisioterapeuta;2;1;1;0;40004
2020-04-05;Segovia;Todos;Otros sanitarios;2;1;1;0;40004
2020-04-05;Soria;Todos;Administrativo;17;11;11;0;42173
2020-04-05;Soria;Todos;Auxiliares sanitarios;37;20;20;0;42173
2020-04-05;Soria;Todos;Enfermero/a;89;54;42;12;42173
2020-04-05;Soria;Todos;Fisioterapeuta;2;1;1;0;42173
2020-04-05;Soria;Todos;Personal en formación;7;2;1;1;42173
2020-04-05;Soria;Todos;Técnicos sanitarios;11;9;6;3;42173
2020-04-05;Valladolid;Todos;Administrativo;47;17;17;0;47186
2020-04-05;Valladolid;Todos;Celador;36;13;12;1;47186
2020-04-05;Valladolid;Todos;Médicos;329;81;73;8;47186
2020-04-05;Valladolid;Todos;Otros sanitarios;8;2;2;0;47186
2020-04-05;Zamora;Todos;Auxiliares sanitarios;10;2;2;0;49275
2020-04-05;Zamora;Todos;Personal en formación;1;0;0;0;49275
2020-04-06;Ávila;Todos;Administrativo;16;13;13;0;5019
2020-04-06;Ávila;Todos;Auxiliares sanitarios;72;33;33;0;5019
2020-04-06;Ávila;Todos;Celador;16;5;5;0;5019
2020-04-06;Ávila;Todos;Servicios de apoyo no sanitario;18;8;8;0;5019
2020-04-06;Burgos;Todos;Administrativo;17;6;6;0;9059
2020-04-06;Burgos;Todos;Auxiliares sanitarios;91;29;26;3;9059
2020-04-06;Burgos;Todos;Fisioterapeuta;3;1;0;1;9059
2020-04-06;Burgos;Todos;Médicos;160;42;27;15;9059
2020-04-06;Burgos;Todos;Técnicos sanitarios;11;4;2;2;9059
2020-04-06;León;Todos;Enfermero/a;236;87;73;14;24089
2020-04-06;León;Todos;Otros;1;0;0;0;24089
2020-04-06;Palencia;Todos;Auxiliares sanitarios;25;8;7;1;34120
2020-04-06;Palencia;Todos;Celador;15;9;8;1;34120
2020-04-06;Palencia;Todos;Médicos;75;18;13;5;34120
2020-04-06;Palencia;Todos;Otros;1;0;0;0;34120
2020-04-06;Palencia;Todos;Personal en formación;16;6;6;0;34120
2020-04-06;Salamanca;Todos;Otros sanitarios;4;3;3;0;37274
2020-04-06;Salamanca;Todos;Servicios de apoyo no sanitario;22;11;9;2;37274
2020-04-06;Segovia;Todos;Fisioterapeuta;2;1;1;0;40004
2020-04-06;Segovia;Todos;Personal en formación;18;9;8;1;40004
2020-04-06;Segovia;Todos;Servicios de apoyo no sanitario;13;9;9;0;40004
2020-04-06;Soria;Todos;Auxiliares sanitarios;37;20;20;0;42173
2020-04-06;Soria;Todos;Otros sanitarios;2;1;1;0;42173
2020-04-06;Soria;Todos;Personal en formación;7;2;1;1;42173
2020-04-06;Soria;Todos;Técnicos sanitarios;11;9;6;3;42173
2020-04-06;Valladolid;Todos;Celador;42;16;15;1;47186
2020-04-06;Valladolid;Todos;Otros;0;0;0;0;47186
2020-04-06;Zamora;Todos;Celador;6;2;2;0;49275
2020-04-07;Ávila;Todos;Auxiliares sanitarios;72;33;33;0;5019
2020-04-07;Ávila;Todos;Celador;17;5;5;0;5019
2020-04-07;Ávila;Todos;Médicos;142;64;61;3;5019
2020-04-07;Ávila;Todos;Otros sanitarios;8;5;5;0;5019
2020-04-07;Ávila;Todos;Servicios de apoyo no sanitario;18;8;8;0;5019
2020-04-07;Burgos;Todos;Enfermero/a;189;56;43;13;9059
2020-04-07;Burgos;Todos;Médicos;165;42;24;18;9059
2020-04-07;Burgos;Todos;Otros sanitarios;3;0;0;0;9059
2020-04-07;León;Todos;Auxiliares sanitarios;83;30;27;3;24089
2020-04-07;León;Todos;Otros sanitarios;8;2;2;0;24089
2020-04-07;Palencia;Todos;Administrativo;7;3;3;0;34120
2020-04-07;Palencia;Todos;Otros;1;0;0;0;34120
2020-04-07;Salamanca;Todos;Celador;43;14;14;0;37274
2020-04-07;Salamanca;Todos;Médicos;264;99;74;25;37274
2020-04-07;Salamanca;Todos;Otros;2;1;1;0;37274
2020-04-07;Segovia;Todos;Administrativo;33;16;15;1;40004
2020-04-07;Segovia;Todos;Auxiliares sanitarios;76;41;40;1;40004
2020-04-07;Segovia;Todos;Fisioterapeuta;3;1;0;1;40004
2020-04-07;Segovia;Todos;Médicos;157;69;53;16;40004
2020-04-07;Segovia;Todos;Otros;0;0;0;0;40004
2020-04-07;Soria;Todos;Otros;0;0;0;0;42173
2020-04-07;Soria;Todos;Personal en formación;7;2;1;1;42173
2020-04-07;Valladolid;Todos;Auxiliares sanitarios;115;35;33;2;47186
2020-04-07;Valladolid;Todos;Enfermero/a;357;107;100;7;47186
2020-04-07;Valladolid;Todos;Técnicos sanitarios;36;9;6;3;47186
2020-04-07;Zamora;Todos;Celador;7;2;2;0;49275
2020-04-07;Zamora;Todos;Personal en formación;1;0;0;0;49275
2020-04-07;Zamora;Todos;Técnicos sanitarios;2;0;0;0;49275
2020-04-08;Ávila;Todos;Servicios de apoyo no sanitario;19;9;8;1;5019
2020-04-08;Ávila;Todos;Técnicos sanitarios;16;6;5;1;5019
2020-04-08;Burgos;Todos;Administrativo;18;6;6;0;9059
2020-04-08;Burgos;Todos;Otros sanitarios;3;0;0;0;9059
2020-04-08;León;Todos;Celador;33;9;8;1;24089
2020-04-08;León;Todos;Otros;1;0;0;0;24089
2020-04-08;León;Todos;Servicios de apoyo no sanitario;7;2;1;1;24089
2020-04-08;Palencia;Todos;Auxiliares sanitarios;29;10;9;1;34120
2020-04-08;Palencia;Todos;Otros;1;0;0;0;34120
2020-04-08;Palencia;Todos;Servicios de apoyo no sanitario;5;2;2;0;34120
2020-04-08;Salamanca;Todos;Administrativo;31;14;13;1;37274
2020-04-08;Salamanca;Todos;Auxiliares sanitarios;125;53;51;2;37274
2020-04-08;Salamanca;Todos;Servicios de apoyo no sanitario;22;11;9;2;37274
2020-04-08;Segovia;Todos;Enfermero/a;208;111;90;21;40004
2020-04-08;Segovia;Todos;Médicos;158;68;49;19;40004
2020-04-08;Segovia;Todos;Otros sanitarios;2;1;1;0;40004
2020-04-08;Segovia;Todos;Servicios de apoyo no sanitario;15;9;9;0;40004
2020-04-08;Soria;Todos;Fisioterapeuta;2;1;1;0;42173
2020-04-08;Soria;Todos;Otros sanitarios;2;1;1;0;42173
2020-04-08;Soria;Todos;Personal en formación;7;2;1;1;42173
2020-04-08;Soria;Todos;Servicios de apoyo no sanitario;2;2;2;0;42173
2020-04-08;Valladolid;Todos;Administrativo;60;19;18;1;47186
2020-04-08;Valladolid;Todos;Enfermero/a;382;109;95;14;47186
2020-04-08;Valladolid;Todos;Médicos;364;87;60;27;47186
2020-04-08;Valladolid;Todos;Otros;0;0;0;0;47186
2020-04-08;Valladolid;Todos;Otros sanitarios;10;4;3;1;47186
2020-04-08;Zamora;Todos;Celador;7;2;2;0;49275
2020-04-08;Zamora;Todos;Personal en formación;1;0;0;0;49275
2020-04-08;Zamora;Todos;Técnicos sanitarios;2;0;0;0;49275
2020-04-09;Ávila;Todos;Enfermero/a;178;74;68;6;5019
2020-04-09;Ávila;Todos;Personal en formación;10;4;3;1;5019
2020-04-09;Ávila;Todos;Técnicos sanitarios;16;6;5;1;5019
2020-04-09;Burgos;Todos;Enfermero/a;208;60;43;17;9059
2020-04-09;Burgos;Todos;Fisioterapeuta;3;1;0;1;9059
2020-04-09;Burgos;Todos;Médicos;176;48;26;22;9059
2020-04-09;Burgos;Todos;Servicios de apoyo no sanitario;4;1;0;1;9059
2020-04-09;León;Todos;Administrativo;43;5;3;2;24089
2020-04-09;León;Todos;Enfermero/a;296;97;80;17;24089
2020-04-09;León;Todos;Personal en formación;45;15;13;2;24089
2020-04-09;Palencia;Todos;Auxiliares sanitarios;35;12;11;1;34120
2020-04-09;Palencia;Todos;Fisioterapeuta;0;0;0;0;34120
2020-04-09;Palencia;Todos;Médicos;81;19;10;9;34120
2020-04-09;Palencia;Todos;Otros;1;0;0;0;34120
2020-04-09;Palencia;Todos;Personal en formación;17;6;3;3;34120
2020-04-09;Salamanca;Todos;Administrativo;33;16;14;2;37274
2020-04-09;Salamanca;Todos;Auxiliares sanitarios;137;59;52;7;37274
2020-04-09;Salamanca;Todos;Celador;44;14;11;3;37274
2020-04-09;Salamanca;Todos;Médicos;274;103;65;38;37274
2020-04-09;Salamanca;Todos;Personal en formación;48;20;11;9;37274
2020-04-09;Segovia;Todos;Celador;28;17;15;2;40004
2020-04-09;Segovia;Todos;Enfermero/a;214;114;90;24;40004
2020-04-09;Segovia;Todos;Servicios de apoyo no sanitario;15;9;9;0;40004
2020-04-09;Segovia;Todos;Técnicos sanitarios;22;13;11;2;40004
2020-04-09;Soria;Todos;Auxiliares sanitarios;46;22;19;3;42173
2020-04-09;Soria;Todos;Celador;16;10;7;3;42173
2020-04-09;Soria;Todos;Otros;0;0;0;0;42173
2020-04-09;Soria;Todos;Servicios de apoyo no sanitario;2;2;2;0;42173
2020-04-09;Valladolid;Todos;Celador;49;17;16;1;47186
2020-04-09;Valladolid;Todos;Fisioterapeuta;10;3;3;0;47186
2020-04-09;Valladolid;Todos;Personal en formación;74;17;12;5;47186
2020-04-09;Valladolid;Todos;Servicios de apoyo no sanitario;30;7;6;1;47186
2020-04-09;Zamora;Todos;Enfermero/a;58;16;13;3;49275
2020-04-09;Zamora;Todos;Fisioterapeuta;0;0;0;0;49275
2020-04-09;Zamora;Todos;Técnicos sanitarios;3;0;0;0;49275
2020-04-10;Ávila;Todos;Administrativo;19;15;13;2;5019
2020-04-10;Ávila;Todos;Celador;19;5;5;0;5019
2020-04-10;Ávila;Todos;Otros;1;1;0;1;5019
2020-04-10;Ávila;Todos;Servicios de apoyo no sanitario;20;9;7;2;5019
2020-04-10;Burgos;Todos;Administrativo;19;7;7;0;9059
2020-04-10;Burgos;Todos;Auxiliares sanitarios;103;33;26;7;9059
2020-04-10;Burgos;Todos;Celador;19;8;5;3;9059
2020-04-10;Burgos;Todos;Enfermero/a;213;62;40;22;9059
2020-04-10;Burgos;Todos;Fisioterapeuta;3;1;0;1;9059
2020-04-10;Burgos;Todos;Médicos;182;48;25;23;9059
2020-04-10;Burgos;Todos;Servicios de apoyo no sanitario;4;1;0;1;9059
2020-04-10;León;Todos;Administrativo;46;7;5;2;24089
2020-04-10;León;Todos;Celador;52;9;7;2;24089
2020-04-10;León;Todos;Enfermero/a;313;99;81;18;24089
2020-04-10;León;Todos;Fisioterapeuta;6;2;0;2;24089
2020-04-10;León;Todos;Médicos;267;71;49;22;24089
2020-04-10;León;Todos;Personal en formación;45;14;12;2;24089
2020-04-10;León;Todos;Servicios de apoyo no sanitario;8;2;1;1;24089
2020-04-10;Palencia;Todos;Auxiliares sanitarios;42;14;13;1;34120
2020-04-10;Palencia;Todos;Servicios de apoyo no sanitario;7;3;3;0;34120
2020-04-10;Palencia;Todos;Técnicos sanitarios;4;2;2;0;34120
2020-04-10;Salamanca;Todos;Técnicos sanitarios;36;17;15;2;37274
2020-04-10;Segovia;Todos;Fisioterapeuta;3;1;0;1;40004
2020-04-10;Segovia;Todos;Personal en formación;19;9;7;2;40004
2020-04-10;Soria;Todos;Otros sanitarios;3;2;2;0;42173
2020-04-10;Valladolid;Todos;Auxiliares sanitarios;141;41;35;6;47186
2020-04-10;Valladolid;Todos;Médicos;389;90;57;33;47186
2020-04-10;Valladolid;Todos;Otros;0;0;0;0;47186
2020-04-10;Valladolid;Todos;Personal en formación;76;17;12;5;47186
2020-04-10;Zamora;Todos;Administrativo;6;3;1;2;49275
2020-04-10;Zamora;Todos;Auxiliares sanitarios;11;2;2;0;49275
2020-04-10;Zamora;Todos;Técnicos sanitarios;3;0;0;0;49275
2020-04-11;Ávila;Todos;Administrativo;20;15;13;2;5019
2020-04-11;Ávila;Todos;Auxiliares sanitarios;83;37;35;2;5019
2020-04-11;Ávila;Todos;Personal en formación;10;4;3;1;5019
2020-04-11;Burgos;Todos;Auxiliares sanitarios;110;34;27;7;9059
2020-04-11;Burgos;Todos;Otros;1;1;0;1;9059
2020-04-11;Burgos;Todos;Otros sanitarios;5;0;0;0;9059
2020-04-11;Burgos;Todos;Técnicos sanitarios;16;4;1;3;9059
2020-04-11;León;Todos;Personal en formación;61;15;12;3;24089
2020-04-11;León;Todos;Servicios de apoyo no sanitario;8;2;1;1;24089
2020-04-11;Palencia;Todos;Administrativo;10;3;3;0;34120
2020-04-11;Palencia;Todos;Fisioterapeuta;0;0;0;0;34120
2020-04-11;Palencia;Todos;Otros;1;0;0;0;34120
2020-04-11;Palencia;Todos;Personal en formación;18;6;3;3;34120
2020-04-11;Palencia;Todos;Técnicos sanitarios;4;2;2;0;34120
2020-04-11;Salamanca;Todos;Auxiliares sanitarios;145;60;52;8;37274
2020-04-11;Salamanca;Todos;Enfermero/a;284;99;84;15;37274
2020-04-11;Salamanca;Todos;Personal en formación;51;20;9;11;37274
2020-04-11;Salamanca;Todos;Servicios de apoyo no sanitario;24;11;7;4;37274
2020-04-11;Segovia;Todos;Auxiliares sanitarios;81;42;38;4;40004
2020-04-11;Soria;Todos;Administrativo;23;12;8;4;42173
2020-04-11;Soria;Todos;Auxiliares sanitarios;49;22;14;8;42173
2020-04-11;Soria;Todos;Enfermero/a;105;62;38;24;42173
2020-04-11;Soria;Todos;Fisioterapeuta;2;1;1;0;42173
2020-04-11;Valladolid;Todos;Administrativo;69;20;18;2;47186
2020-04-11;Valladolid;Todos;Enfermero/a;433;120;102;18;47186
2020-04-11;Valladolid;Todos;Médicos;398;92;59;33;47186
2020-04-11;Valladolid;Todos;Otros;0;0;0;0;47186
2020-04-11;Valladolid;Todos;Otros sanitarios;11;4;3;1;47186
2020-04-11;Valladolid;Todos;Personal en formación;79;17;12;5;47186
2020-04-11;Zamora;Todos;Administrativo;6;3;1;2;49275
2020-04-11;Zamora;Todos;Auxiliares sanitarios;11;2;2;0;49275
2020-04-11;Zamora;Todos;Fisioterapeuta;0;0;0;0;49275
2020-04-11;Zamora;Todos;Personal en formación;1;0;0;0;49275
2020-04-11;Zamora;Todos;Servicios de apoyo no sanitario;0;0;0;0;49275
2020-04-11;Zamora;Todos;Técnicos sanitarios;3;0;0;0;49275
2020-04-12;Ávila;Todos;Auxiliares sanitarios;82;36;34;2;5019
2020-04-12;Ávila;Todos;Celador;20;5;5;0;5019
2020-04-12;Ávila;Todos;Servicios de apoyo no sanitario;21;9;7;2;5019
2020-04-12;Burgos;Todos;Auxiliares sanitarios;113;34;26;8;9059
2020-04-12;Burgos;Todos;Otros;1;1;0;1;9059
2020-04-12;Burgos;Todos;Servicios de apoyo no sanitario;4;1;0;1;9059
2020-04-12;León;Todos;Auxiliares sanitarios;135;42;36;6;24089
2020-04-12;León;Todos;Celador;65;9;7;2;24089
2020-04-12;León;Todos;Fisioterapeuta;9;2;0;2;24089
2020-04-12;León;Todos;Médicos;370;81;51;30;24089
2020-04-12;León;Todos;Otros sanitarios;18;3;3;0;24089
2020-04-12;León;Todos;Servicios de apoyo no sanitario;8;2;1;1;24089
2020-04-12;León;Todos;Técnicos sanitarios;27;6;4;2;24089
2020-04-12;Palencia;Todos;Celador;20;11;9;2;34120
2020-04-12;Palencia;Todos;Otros;1;0;0;0;34120
2020-04-12;Palencia;Todos;Personal en formación;18;6;3;3;34120
2020-04-12;Salamanca;Todos;Celador;49;17;14;3;37274
2020-04-12;Salamanca;Todos;Enfermero/a;287;99;83;16;37274
2020-04-12;Salamanca;Todos;Fisioterapeuta;7;4;4;0;37274
2020-04-12;Salamanca;Todos;Personal en formación;51;20;9;11;37274
2020-04-12;Salamanca;Todos;Servicios de apoyo no sanitario;24;11;7;4;37274
2020-04-12;Salamanca;Todos;Técnicos sanitarios;36;17;15;2;37274
2020-04-12;Segovia;Todos;Administrativo;33;16;11;5;40004
2020-04-12;Segovia;Todos;Enfermero/a;220;117;83;34;40004
2020-04-12;Segovia;Todos;Otros sanitarios;2;1;1;0;40004
2020-04-12;Segovia;Todos;Servicios de apoyo no sanitario;15;9;8;1;40004
2020-04-12;Soria;Todos;Médicos;91;51;26;25;42173
2020-04-12;Soria;Todos;Otros;0;0;0;0;42173
2020-04-12;Soria;Todos;Otros sanitarios;3;2;2;0;42173
2020-04-12;Valladolid;Todos;Auxiliares sanitarios;145;42;36;6;47186
2020-04-12;Valladolid;Todos;Celador;52;18;15;3;47186
2020-04-12;Valladolid;Todos;Médicos;403;92;58;34;47186
2020-04-12;Valladolid;Todos;Personal en formación;81;19;13;6;47186
2020-04-12;Zamora;Todos;Auxiliares sanitarios;12;2;2;0;49275
2020-04-12;Zamora;Todos;Enfermero/a;64;19;12;7;49275
2020-04-12;Zamora;Todos;Fisioterapeuta;0;0;0;0;49275
2020-04-12;Zamora;Todos;Médicos;70;19;8;11;49275
2020-04-12;Zamora;Todos;Otros;0;0;0;0;49275
2020-04-12;Zamora;Todos;Personal en formación;1;0;0;0;49275
2020-04-12;Zamora;Todos;Técnicos sanitarios;3;0;0;0;49275
2020-04-13;Ávila;Todos;Administrativo;20;15;12;3;5019
2020-04-13;Ávila;Todos;Servicios de apoyo no sanitario;21;9;7;2;5019
2020-04-13;Ávila;Todos;Técnicos sanitarios;19;7;6;1;5019
2020-04-13;Burgos;Todos;Administrativo;46;8;8;0;9059
2020-04-13;Burgos;Todos;Celador;31;11;7;4;9059
2020-04-13;Burgos;Todos;Enfermero/a;279;66;40;26;9059
2020-04-13;Burgos;Todos;Personal en formación;24;4;0;4;9059
2020-04-13;Burgos;Todos;Servicios de apoyo no sanitario;5;2;1;1;9059
2020-04-13;Burgos;Todos;Técnicos sanitarios;17;4;1;3;9059
2020-04-13;León;Todos;Administrativo;87;12;7;5;24089
2020-04-13;León;Todos;Auxiliares sanitarios;170;44;35;9;24089
2020-04-13;León;Todos;Enfermero/a;530;116;84;32;24089
2020-04-13;León;Todos;Fisioterapeuta;12;2;0;2;24089
2020-04-13;León;Todos;Médicos;421;82;49;33;24089
2020-04-13;León;Todos;Otros;2;0;0;0;24089
2020-04-13;León;Todos;Otros sanitarios;20;3;3;0;24089
2020-04-13;León;Todos;Personal en formación;72;15;12;3;24089
2020-04-13;León;Todos;Técnicos sanitarios;31;6;4;2;24089
2020-04-13;Palencia;Todos;Administrativo;28;3;3;0;34120
2020-04-13;Palencia;Todos;Auxiliares sanitarios;48;14;13;1;34120
2020-04-13;Palencia;Todos;Otros;1;0;0;0;34120
2020-04-13;Palencia;Todos;Otros sanitarios;5;1;0;1;34120
2020-04-13;Palencia;Todos;Técnicos sanitarios;5;3;3;0;34120
2020-04-13;Salamanca;Todos;Fisioterapeuta;7;4;4;0;37274
2020-04-13;Salamanca;Todos;Otros sanitarios;6;4;4;0;37274
2020-04-13;Salamanca;Todos;Servicios de apoyo no sanitario;27;13;8;5;37274
2020-04-13;Salamanca;Todos;Técnicos sanitarios;36;17;15;2;37274
2020-04-13;Segovia;Todos;Administrativo;33;16;10;6;40004
2020-04-13;Segovia;Todos;Celador;31;18;12;6;40004
2020-04-13;Segovia;Todos;Fisioterapeuta;3;1;0;1;40004
2020-04-13;Segovia;Todos;Médicos;168;73;42;31;40004
2020-04-13;Segovia;Todos;Otros;0;0;0;0;40004
2020-04-13;Segovia;Todos;Otros sanitarios;2;1;1;0;40004
2020-04-13;Soria;Todos;Enfermero/a;106;63;37;26;42173
2020-04-13;Soria;Todos;Otros;0;0;0;0;42173
2020-04-13;Soria;Todos;Otros sanitarios;3;2;2;0;42173
2020-04-13;Soria;Todos;Personal en formación;10;2;1;1;42173
2020-04-13;Valladolid;Todos;Celador;58;18;15;3;47186
2020-04-13;Valladolid;Todos;Personal en formación;95;19;13;6;47186
2020-04-13;Valladolid;Todos;Servicios de apoyo no sanitario;34;8;6;2;47186
2020-04-13;Zamora;Todos;Enfermero/a;66;20;13;7;49275
2020-04-13;Zamora;Todos;Fisioterapeuta;0;0;0;0;49275
2020-04-13;Zamora;Todos;Otros sanitarios;2;1;1;0;49275
2020-04-13;Zamora;Todos;Técnicos sanitarios;3;0;0;0;49275
2020-04-14;Ávila;Todos;Auxiliares sanitarios;86;37;35;2;5019
2020-04-14;Ávila;Todos;Enfermero/a;195;78;69;9;5019
2020-04-14;Ávila;Todos;Otros;1;1;0;1;5019
2020-04-14;Burgos;Todos;Auxiliares sanitarios;134;36;24;12;9059
2020-04-14;Burgos;Todos;Celador;41;11;6;5;9059
2020-04-14;Burgos;Todos;Personal en formación;24;4;0;4;9059
2020-04-14;León;Todos;Administrativo;88;13;7;6;24089
2020-04-14;León;Todos;Auxiliares sanitarios;200;46;37;9;24089
2020-04-14;León;Todos;Médicos;449;84;48;36;24089
2020-04-14;León;Todos;Otros sanitarios;20;3;3;0;24089
2020-04-14;León;Todos;Técnicos sanitarios;34;6;4;2;24089
2020-04-14;Palencia;Todos;Fisioterapeuta;2;0;0;0;34120
2020-04-14;Palencia;Todos;Médicos;112;21;11;10;34120
2020-04-14;Palencia;Todos;Otros;1;0;0;0;34120
2020-04-14;Salamanca;Todos;Auxiliares sanitarios;160;66;57;9;37274
2020-04-14;Salamanca;Todos;Celador;54;20;17;3;37274
2020-04-14;Salamanca;Todos;Enfermero/a;318;108;90;18;37274
2020-04-14;Salamanca;Todos;Médicos;297;109;58;51;37274
2020-04-14;Salamanca;Todos;Otros;3;1;1;0;37274
2020-04-14;Salamanca;Todos;Personal en formación;54;21;10;11;37274
2020-04-14;Segovia;Todos;Fisioterapeuta;4;1;0;1;40004
2020-04-14;Segovia;Todos;Médicos;172;75;39;36;40004
2020-04-14;Segovia;Todos;Otros;0;0;0;0;40004
2020-04-14;Segovia;Todos;Otros sanitarios;2;1;1;0;40004
2020-04-14;Soria;Todos;Técnicos sanitarios;12;8;5;3;42173
2020-04-14;Valladolid;Todos;Auxiliares sanitarios;172;44;37;7;47186
2020-04-14;Valladolid;Todos;Técnicos sanitarios;50;9;6;3;47186
2020-04-14;Zamora;Todos;Médicos;71;20;9;11;49275
2020-04-14;Zamora;Todos;Personal en formación;2;0;0;0;49275
2020-04-15;Ávila;Todos;Administrativo;22;16;13;3;5019
2020-04-15;Ávila;Todos;Auxiliares sanitarios;86;37;35;2;5019
2020-04-15;Ávila;Todos;Fisioterapeuta;5;0;0;0;5019
2020-04-15;Ávila;Todos;Servicios de apoyo no sanitario;21;9;7;2;5019
2020-04-15;Ávila;Todos;Técnicos sanitarios;19;7;6;1;5019
2020-04-15;Burgos;Todos;Celador;49;11;6;5;9059
2020-04-15;Burgos;Todos;Otros sanitarios;12;0;0;0;9059
2020-04-15;Burgos;Todos;Servicios de apoyo no sanitario;7;2;1;1;9059
2020-04-15;León;Todos;Auxiliares sanitarios;214;47;35;12;24089
2020-04-15;León;Todos;Fisioterapeuta;13;2;0;2;24089
2020-04-15;León;Todos;Médicos;467;85;46;39;24089
2020-04-15;León;Todos;Otros;3;0;0;0;24089
2020-04-15;Palencia;Todos;Administrativo;46;3;3;0;34120
2020-04-15;Palencia;Todos;Celador;30;11;9;2;34120
2020-04-15;Palencia;Todos;Otros;2;0;0;0;34120
2020-04-15;Palencia;Todos;Personal en formación;18;6;3;3;34120
2020-04-15;Palencia;Todos;Servicios de apoyo no sanitario;13;3;3;0;34120
2020-04-15;Salamanca;Todos;Administrativo;46;19;15;4;37274
2020-04-15;Salamanca;Todos;Auxiliares sanitarios;168;68;53;15;37274
2020-04-15;Salamanca;Todos;Fisioterapeuta;7;4;4;0;37274
2020-04-15;Salamanca;Todos;Médicos;308;114;64;50;37274
2020-04-15;Salamanca;Todos;Otros;3;1;1;0;37274
2020-04-15;Salamanca;Todos;Servicios de apoyo no sanitario;28;13;8;5;37274
2020-04-15;Salamanca;Todos;Técnicos sanitarios;38;17;14;3;37274
2020-04-15;Segovia;Todos;Auxiliares sanitarios;92;44;36;8;40004
2020-04-15;Segovia;Todos;Otros;0;0;0;0;40004
2020-04-15;Segovia;Todos;Otros sanitarios;2;1;1;0;40004
2020-04-15;Segovia;Todos;Servicios de apoyo no sanitario;16;9;5;4;40004
2020-04-15;Soria;Todos;Enfermero/a;110;63;34;29;42173
2020-04-15;Soria;Todos;Otros sanitarios;3;2;1;1;42173
2020-04-15;Soria;Todos;Personal en formación;10;2;1;1;42173
2020-04-15;Valladolid;Todos;Administrativo;135;23;18;5;47186
2020-04-15;Valladolid;Todos;Enfermero/a;615;129;98;31;47186
2020-04-15;Zamora;Todos;Administrativo;7;4;2;2;49275
2020-04-15;Zamora;Todos;Auxiliares sanitarios;15;4;4;0;49275
2020-04-15;Zamora;Todos;Médicos;72;20;9;11;49275
2020-04-15;Zamora;Todos;Otros sanitarios;2;1;1;0;49275
2020-04-15;Zamora;Todos;Técnicos sanitarios;4;0;0;0;49275
2020-04-16;Ávila;Todos;Administrativo;24;16;13;3;5019
2020-04-16;Ávila;Todos;Fisioterapeuta;5;0;0;0;5019
2020-04-16;Ávila;Todos;Médicos;175;69;47;22;5019
2020-04-16;Ávila;Todos;Otros sanitarios;9;5;5;0;5019
2020-04-16;Burgos;Todos;Técnicos sanitarios;23;4;1;3;9059
2020-04-16;León;Todos;Administrativo;95;14;6;8;24089
2020-04-16;León;Todos;Auxiliares sanitarios;219;47;35;12;24089
2020-04-16;León;Todos;Celador;86;14;10;4;24089
2020-04-16;León;Todos;Enfermero/a;659;128;83;45;24089
2020-04-16;León;Todos;Fisioterapeuta;15;2;0;2;24089
2020-04-16;León;Todos;Personal en formación;78;15;10;5;24089
2020-04-16;Palencia;Todos;Administrativo;49;4;4;0;34120
2020-04-16;Palencia;Todos;Médicos;129;22;12;10;34120
2020-04-16;Palencia;Todos;Personal en formación;18;6;3;3;34120
2020-04-16;Palencia;Todos;Servicios de apoyo no sanitario;13;3;3;0;34120
2020-04-16;Palencia;Todos;Técnicos sanitarios;5;3;3;0;34120
2020-04-16;Salamanca;Todos;Otros sanitarios;7;4;4;0;37274
2020-04-16;Salamanca;Todos;Servicios de apoyo no sanitario;29;13;8;5;37274
2020-04-16;Segovia;Todos;Auxiliares sanitarios;96;46;33;13;40004
2020-04-16;Segovia;Todos;Médicos;185;76;30;46;40004
2020-04-16;Segovia;Todos;Servicios de apoyo no sanitario;16;9;5;4;40004
2020-04-16;Soria;Todos;Otros sanitarios;3;2;1;1;42173
2020-04-16;Valladolid;Todos;Administrativo;162;24;19;5;47186
2020-04-16;Valladolid;Todos;Auxiliares sanitarios;194;46;37;9;47186
2020-04-16;Valladolid;Todos;Celador;78;18;15;3;47186
2020-04-16;Valladolid;Todos;Otros;3;0;0;0;47186
2020-04-16;Zamora;Todos;Enfermero/a;69;20;16;4;49275
2020-04-16;Zamora;Todos;Fisioterapeuta;0;0;0;0;49275
2020-04-16;Zamora;Todos;Otros;0;0;0;0;49275
2020-04-16;Zamora;Todos;Técnicos sanitarios;4;0;0;0;49275
2020-04-17;Ávila;Todos;Médicos;178;70;47;23;5019
2020-04-17;Ávila;Todos;Otros sanitarios;9;5;5;0;5019
2020-04-17;Ávila;Todos;Personal en formación;10;4;2;2;5019
2020-04-17;Burgos;Todos;Administrativo;98;8;5;3;9059
2020-04-17;Burgos;Todos;Celador;54;11;5;6;9059
2020-04-17;Burgos;Todos;Enfermero/a;439;71;36;35;9059
2020-04-17;Burgos;Todos;Otros;7;1;0;1;9059
2020-04-17;Burgos;Todos;Personal en formación;29;4;0;4;9059
2020-04-17;León;Todos;Administrativo;99;14;6;8;24089
2020-04-17;León;Todos;Fisioterapeuta;16;2;0;2;24089
2020-04-17;Palencia;Todos;Administrativo;52;4;4;0;34120
2020-04-17;Palencia;Todos;Auxiliares sanitarios;54;14;13;1;34120
2020-04-17;Palencia;Todos;Médicos;132;22;12;10;34120
2020-04-17;Palencia;Todos;Otros sanitarios;7;1;0;1;34120
2020-04-17;Palencia;Todos;Personal en formación;18;6;3;3;34120
2020-04-17;Salamanca;Todos;Celador;59;22;17;5;37274
2020-04-17;Salamanca;Todos;Enfermero/a;398;116;66;50;37274
2020-04-17;Salamanca;Todos;Fisioterapeuta;7;4;2;2;37274
2020-04-17;Salamanca;Todos;Médicos;332;117;51;66;37274
2020-04-17;Salamanca;Todos;Otros sanitarios;8;4;4;0;37274
2020-04-17;Segovia;Todos;Administrativo;38;16;5;11;40004
2020-04-17;Segovia;Todos;Celador;39;18;10;8;40004
2020-04-17;Segovia;Todos;Otros sanitarios;2;1;1;0;40004
2020-04-17;Segovia;Todos;Personal en formación;24;10;5;5;40004
2020-04-17;Segovia;Todos;Servicios de apoyo no sanitario;16;9;5;4;40004
2020-04-17;Soria;Todos;Auxiliares sanitarios;54;22;8;14;42173
2020-04-17;Soria;Todos;Celador;17;10;6;4;42173
2020-04-17;Soria;Todos;Fisioterapeuta;3;1;1;0;42173
2020-04-17;Soria;Todos;Otros;0;0;0;0;42173
2020-04-17;Soria;Todos;Personal en formación;10;2;1;1;42173
2020-04-17;Soria;Todos;Servicios de apoyo no sanitario;3;2;1;1;42173
2020-04-17;Valladolid;Todos;Celador;88;18;14;4;47186
2020-04-17;Valladolid;Todos;Otros;3;0;0;0;47186
2020-04-17;Valladolid;Todos;Técnicos sanitarios;58;9;5;4;47186
2020-04-17;Zamora;Todos;Administrativo;7;4;2;2;49275
2020-04-17;Zamora;Todos;Fisioterapeuta;0;0;0;0;49275
2020-04-17;Zamora;Todos;Otros;0;0;0;0;49275
2020-04-18;Ávila;Todos;Celador;23;5;5;0;5019
2020-04-18;Ávila;Todos;Médicos;179;70;46;24;5019
2020-04-18;Ávila;Todos;Otros sanitarios;9;5;5;0;5019
2020-04-18;Ávila;Todos;Técnicos sanitarios;19;7;6;1;5019
2020-04-18;Burgos;Todos;Auxiliares sanitarios;150;38;21;17;9059
2020-04-18;Burgos;Todos;Fisioterapeuta;17;1;0;1;9059
2020-04-18;Burgos;Todos;Médicos;382;52;22;30;9059
2020-04-18;Burgos;Todos;Técnicos sanitarios;24;4;1;3;9059
2020-04-18;León;Todos;Auxiliares sanitarios;245;49;30;19;24089
2020-04-18;León;Todos;Enfermero/a;695;132;77;55;24089
2020-04-18;León;Todos;Fisioterapeuta;16;2;0;2;24089
2020-04-18;León;Todos;Médicos;529;88;42;46;24089
2020-04-18;León;Todos;Otros sanitarios;23;3;2;1;24089
2020-04-18;León;Todos;Personal en formación;79;15;8;7;24089
2020-04-18;León;Todos;Servicios de apoyo no sanitario;12;3;1;2;24089
2020-04-18;Palencia;Todos;Médicos;132;22;11;11;34120
2020-04-18;Palencia;Todos;Otros sanitarios;7;1;0;1;34120
2020-04-18;Palencia;Todos;Técnicos sanitarios;6;3;3;0;34120
2020-04-18;Salamanca;Todos;Personal en formación;64;23;11;12;37274
2020-04-18;Segovia;Todos;Auxiliares sanitarios;97;46;32;14;40004
2020-04-18;Segovia;Todos;Técnicos sanitarios;28;13;6;7;40004
2020-04-18;Soria;Todos;Administrativo;23;12;6;6;42173
2020-04-18;Soria;Todos;Otros;0;0;0;0;42173
2020-04-18;Soria;Todos;Servicios de apoyo no sanitario;3;2;1;1;42173
2020-04-18;Valladolid;Todos;Administrativo;184;24;13;11;47186
2020-04-18;Valladolid;Todos;Auxiliares sanitarios;215;48;37;11;47186
2020-04-18;Valladolid;Todos;Enfermero/a;709;134;89;45;47186
2020-04-18;Zamora;Todos;Administrativo;7;4;2;2;49275
2020-04-18;Zamora;Todos;Otros sanitarios;2;1;1;0;49275
2020-04-18;Zamora;Todos;Técnicos sanitarios;4;0;0;0;49275
2020-04-19;Ávila;Todos;Auxiliares sanitarios;94;37;33;4;5019
2020-04-19;Ávila;Todos;Fisioterapeuta;5;0;0;0;5019
2020-04-19;Ávila;Todos;Otros;1;1;0;1;5019
2020-04-19;Ávila;Todos;Servicios de apoyo no sanitario;21;9;7;2;5019
2020-04-19;Burgos;Todos;Fisioterapeuta;18;1;0;1;9059
2020-04-19;Burgos;Todos;Personal en formación;29;4;0;4;9059
2020-04-19;León;Todos;Enfermero/a;696;132;77;55;24089
2020-04-19;León;Todos;Médicos;529;88;42;46;24089
2020-04-19;León;Todos;Otros sanitarios;23;3;2;1;24089
2020-04-19;León;Todos;Personal en formación;79;15;8;7;24089
2020-04-19;León;Todos;Técnicos sanitarios;39;6;4;2;24089
2020-04-19;Palencia;Todos;Administrativo;52;4;4;0;34120
2020-04-19;Palencia;Todos;Auxiliares sanitarios;55;14;13;1;34120
2020-04-19;Palencia;Todos;Médicos;134;22;11;11;34120
2020-04-19;Salamanca;Todos;Administrativo;50;19;9;10;37274
2020-04-19;Salamanca;Todos;Enfermero/a;400;117;66;51;37274
2020-04-19;Segovia;Todos;Celador;39;18;10;8;40004
2020-04-19;Segovia;Todos;Servicios de apoyo no sanitario;16;9;5;4;40004
2020-04-19;Soria;Todos;Administrativo;23;12;6;6;42173
2020-04-19;Soria;Todos;Médicos;108;54;24;30;42173
2020-04-19;Soria;Todos;Otros sanitarios;3;2;1;1;42173
2020-04-19;Valladolid;Todos;Auxiliares sanitarios;217;48;37;11;47186
2020-04-19;Valladolid;Todos;Otros sanitarios;18;4;1;3;47186
2020-04-19;Valladolid;Todos;Servicios de apoyo no sanitario;38;8;4;4;47186
2020-04-19;Zamora;Todos;Enfermero/a;72;20;16;4;49275
2020-04-19;Zamora;Todos;Fisioterapeuta;0;0;0;0;49275
2020-04-19;Zamora;Todos;Otros sanitarios;2;1;1;0;49275
2020-04-20;Ávila;Todos;Auxiliares sanitarios;96;37;32;5;5019
2020-04-20;Ávila;Todos;Otros;1;1;0;1;5019
2020-04-20;Ávila;Todos;Técnicos sanitarios;19;7;6;1;5019
2020-04-20;Burgos;Todos;Celador;56;11;3;8;9059
2020-04-20;Burgos;Todos;Enfermero/a;471;73;33;40;9059
2020-04-20;Burgos;Todos;Personal en formación;32;4;0;4;9059
2020-04-20;León;Todos;Otros sanitarios;23;3;1;2;24089
2020-04-20;León;Todos;Técnicos sanitarios;39;6;2;4;24089
2020-04-20;Palencia;Todos;Fisioterapeuta;5;1;1;0;34120
2020-04-20;Palencia;Todos;Médicos;136;22;11;11;34120
2020-04-20;Palencia;Todos;Otros sanitarios;7;1;0;1;34120
2020-04-20;Salamanca;Todos;Celador;63;24;17;7;37274
2020-04-20;Salamanca;Todos;Médicos;351;122;51;71;37274
2020-04-20;Salamanca;Todos;Técnicos sanitarios;40;17;11;6;37274
2020-04-20;Segovia;Todos;Administrativo;39;16;5;11;40004
2020-04-20;Segovia;Todos;Celador;40;18;8;10;40004
2020-04-20;Segovia;Todos;Personal en formación;25;11;5;6;40004
2020-04-20;Soria;Todos;Administrativo;24;12;6;6;42173
2020-04-20;Soria;Todos;Auxiliares sanitarios;61;23;9;14;42173
2020-04-20;Soria;Todos;Celador;18;10;3;7;42173
2020-04-20;Soria;Todos;Personal en formación;10;2;1;1;42173
2020-04-20;Soria;Todos;Técnicos sanitarios;13;8;4;4;42173
2020-04-20;Valladolid;Todos;Médicos;746;109;43;66;47186
2020-04-20;Valladolid;Todos;Otros sanitarios;20;4;1;3;47186
2020-04-20;Valladolid;Todos;Técnicos sanitarios;59;10;5;5;47186
2020-04-20;Zamora;Todos;Celador;15;2;2;0;49275
2020-04-20;Zamora;Todos;Enfermero/a;92;22;17;5;49275
2020-04-20;Zamora;Todos;Médicos;95;20;6;14;49275
2020-04-21;Ávila;Todos;Administrativo;25;16;12;4;5019
2020-04-21;Ávila;Todos;Enfermero/a;214;81;64;17;5019
2020-04-21;Ávila;Todos;Personal en formación;10;4;2;2;5019
2020-04-21;Burgos;Todos;Celador;57;11;2;9;9059
2020-04-21;Burgos;Todos;Enfermero/a;485;73;33;40;9059
2020-04-21;Burgos;Todos;Médicos;402;58;21;37;9059
2020-04-21;Burgos;Todos;Otros;7;1;0;1;9059
2020-04-21;León;Todos;Administrativo;122;14;6;8;24089
2020-04-21;León;Todos;Auxiliares sanitarios;282;51;28;23;24089
2020-04-21;León;Todos;Enfermero/a;763;140;84;56;24089
2020-04-21;Palencia;Todos;Auxiliares sanitarios;60;15;14;1;34120
2020-04-21;Salamanca;Todos;Auxiliares sanitarios;206;75;43;32;37274
2020-04-21;Salamanca;Todos;Médicos;356;122;48;74;37274
2020-04-21;Salamanca;Todos;Otros;4;2;2;0;37274
2020-04-21;Segovia;Todos;Celador;43;19;9;10;40004
2020-04-21;Segovia;Todos;Otros sanitarios;2;1;1;0;40004
2020-04-21;Segovia;Todos;Servicios de apoyo no sanitario;19;9;4;5;40004
2020-04-21;Segovia;Todos;Técnicos sanitarios;30;13;6;7;40004
2020-04-21;Soria;Todos;Celador;18;10;3;7;42173
2020-04-21;Soria;Todos;Enfermero/a;135;67;30;37;42173
2020-04-21;Soria;Todos;Fisioterapeuta;5;1;0;1;42173
2020-04-21;Soria;Todos;Otros;0;0;0;0;42173
2020-04-21;Soria;Todos;Servicios de apoyo no sanitario;3;2;1;1;42173
2020-04-21;Valladolid;Todos;Celador;97;18;13;5;47186
2020-04-21;Valladolid;Todos;Médicos;787;112;40;72;47186
2020-04-21;Valladolid;Todos;Otros sanitarios;20;4;1;3;47186
2020-04-21;Valladolid;Todos;Servicios de apoyo no sanitario;40;8;4;4;47186
2020-04-21;Valladolid;Todos;Técnicos sanitarios;66;10;5;5;47186
2020-04-21;Zamora;Todos;Administrativo;14;6;4;2;49275
2020-04-21;Zamora;Todos;Auxiliares sanitarios;34;5;4;1;49275
2020-04-21;Zamora;Todos;Fisioterapeuta;1;1;1;0;49275
2020-04-21;Zamora;Todos;Otros;0;0;0;0;49275
2020-04-21;Zamora;Todos;Otros sanitarios;2;1;0;1;49275
2020-04-21;Zamora;Todos;Técnicos sanitarios;4;0;0;0;49275
2020-04-22;Ávila;Todos;Administrativo;25;16;12;4;5019
2020-04-22;Ávila;Todos;Auxiliares sanitarios;104;39;33;6;5019
2020-04-22;Ávila;Todos;Celador;31;8;7;1;5019
2020-04-22;Ávila;Todos;Fisioterapeuta;6;0;0;0;5019
2020-04-22;Ávila;Todos;Otros sanitarios;10;5;5;0;5019
2020-04-22;Ávila;Todos;Servicios de apoyo no sanitario;22;9;7;2;5019
2020-04-22;Ávila;Todos;Técnicos sanitarios;19;7;6;1;5019
2020-04-22;Burgos;Todos;Administrativo;107;9;4;5;9059
2020-04-22;Burgos;Todos;Auxiliares sanitarios;188;39;18;21;9059
2020-04-22;Burgos;Todos;Otros;7;1;0;1;9059
2020-04-22;León;Todos;Administrativo;127;14;5;9;24089
2020-04-22;León;Todos;Celador;104;16;9;7;24089
2020-04-22;León;Todos;Otros sanitarios;24;3;1;2;24089
2020-04-22;León;Todos;Personal en formación;101;16;6;10;24089
2020-04-22;León;Todos;Técnicos sanitarios;49;7;3;4;24089
2020-04-22;Palencia;Todos;Administrativo;59;5;5;0;34120
2020-04-22;Palencia;Todos;Auxiliares sanitarios;60;15;12;3;34120
2020-04-22;Palencia;Todos;Celador;32;12;9;3;34120
2020-04-22;Palencia;Todos;Personal en formación;18;6;2;4;34120
2020-04-22;Salamanca;Todos;Celador;65;25;14;11;37274
2020-04-22;Salamanca;Todos;Médicos;360;123;47;76;37274
2020-04-22;Segovia;Todos;Auxiliares sanitarios;125;48;21;27;40004
2020-04-22;Segovia;Todos;Enfermero/a;279;125;33;92;40004
2020-04-22;Soria;Todos;Administrativo;32;15;8;7;42173
2020-04-22;Soria;Todos;Auxiliares sanitarios;76;23;10;13;42173
2020-04-22;Soria;Todos;Otros;0;0;0;0;42173
2020-04-22;Valladolid;Todos;Administrativo;227;27;12;15;47186
2020-04-22;Valladolid;Todos;Médicos;803;115;39;76;47186
2020-04-22;Zamora;Todos;Administrativo;20;6;4;2;49275
2020-04-22;Zamora;Todos;Enfermero/a;118;22;14;8;49275
2020-04-22;Zamora;Todos;Médicos;119;19;5;14;49275
2020-04-22;Zamora;Todos;Otros;0;0;0;0;49275
2020-04-23;Ávila;Todos;Auxiliares sanitarios;114;39;31;8;5019
2020-04-23;Ávila;Todos;Otros sanitarios;10;5;5;0;5019
2020-04-23;Ávila;Todos;Servicios de apoyo no sanitario;22;9;7;2;5019
2020-04-23;Ávila;Todos;Técnicos sanitarios;19;7;6;1;5019
2020-04-23;Burgos;Todos;Administrativo;107;9;4;5;9059
2020-04-23;Burgos;Todos;Celador;61;11;2;9;9059
2020-04-23;Burgos;Todos;Servicios de apoyo no sanitario;13;3;2;1;9059
2020-04-23;León;Todos;Celador;104;16;8;8;24089
2020-04-23;León;Todos;Servicios de apoyo no sanitario;17;3;1;2;24089
2020-04-23;Palencia;Todos;Enfermero/a;178;42;32;10;34120
2020-04-23;Palencia;Todos;Servicios de apoyo no sanitario;14;3;3;0;34120
2020-04-23;Palencia;Todos;Técnicos sanitarios;8;3;3;0;34120
2020-04-23;Salamanca;Todos;Administrativo;55;20;9;11;37274
2020-04-23;Salamanca;Todos;Médicos;361;124;47;77;37274
2020-04-23;Salamanca;Todos;Otros sanitarios;8;4;3;1;37274
2020-04-23;Salamanca;Todos;Personal en formación;82;27;13;14;37274
2020-04-23;Segovia;Todos;Auxiliares sanitarios;126;49;22;27;40004
2020-04-23;Segovia;Todos;Celador;50;21;10;11;40004
2020-04-23;Segovia;Todos;Fisioterapeuta;4;1;0;1;40004
2020-04-23;Segovia;Todos;Otros;0;0;0;0;40004
2020-04-23;Segovia;Todos;Personal en formación;26;11;4;7;40004
2020-04-23;Segovia;Todos;Servicios de apoyo no sanitario;19;9;3;6;40004
2020-04-23;Segovia;Todos;Técnicos sanitarios;31;13;6;7;40004
2020-04-23;Soria;Todos;Celador;28;10;3;7;42173
2020-04-23;Soria;Todos;Otros;0;0;0;0;42173
2020-04-23;Soria;Todos;Servicios de apoyo no sanitario;6;2;1;1;42173
2020-04-23;Soria;Todos;Técnicos sanitarios;15;8;4;4;42173
2020-04-23;Valladolid;Todos;Auxiliares sanitarios;266;51;35;16;47186
2020-04-23;Valladolid;Todos;Celador;103;19;14;5;47186
2020-04-23;Valladolid;Todos;Enfermero/a;857;145;86;59;47186
2020-04-23;Valladolid;Todos;Médicos;811;115;39;76;47186
2020-04-23;Valladolid;Todos;Otros;4;0;0;0;47186
2020-04-23;Valladolid;Todos;Otros sanitarios;20;4;1;3;47186
2020-04-23;Zamora;Todos;Auxiliares sanitarios;53;6;5;1;49275
2020-04-23;Zamora;Todos;Celador;25;2;1;1;49275
2020-04-23;Zamora;Todos;Personal en formación;7;0;0;0;49275
2020-04-23;Zamora;Todos;Servicios de apoyo no sanitario;1;0;0;0;49275
2020-04-24;Ávila;Todos;Enfermero/a;279;82;65;17;5019
2020-04-24;Ávila;Todos;Servicios de apoyo no sanitario;22;9;8;1;5019
2020-04-24;Ávila;Todos;Técnicos sanitarios;19;7;6;1;5019
2020-04-24;Burgos;Todos;Celador;72;12;3;9;9059
2020-04-24;Burgos;Todos;Médicos;436;59;22;37;9059
2020-04-24;Burgos;Todos;Servicios de apoyo no sanitario;16;3;2;1;9059
2020-04-24;León;Todos;Administrativo;131;14;5;9;24089
2020-04-24;León;Todos;Auxiliares sanitarios;319;55;25;30;24089
2020-04-24;León;Todos;Fisioterapeuta;16;2;0;2;24089
2020-04-24;León;Todos;Personal en formación;109;16;5;11;24089
2020-04-24;León;Todos;Técnicos sanitarios;48;7;2;5;24089
2020-04-24;Palencia;Todos;Administrativo;59;5;5;0;34120
2020-04-24;Palencia;Todos;Fisioterapeuta;6;1;1;0;34120
2020-04-24;Palencia;Todos;Médicos;158;26;11;15;34120
2020-04-24;Salamanca;Todos;Administrativo;57;21;10;11;37274
2020-04-24;Salamanca;Todos;Auxiliares sanitarios;221;79;39;40;37274
2020-04-24;Salamanca;Todos;Celador;67;25;13;12;37274
2020-04-24;Salamanca;Todos;Fisioterapeuta;6;4;1;3;37274
2020-04-24;Salamanca;Todos;Otros;4;2;2;0;37274
2020-04-24;Salamanca;Todos;Técnicos sanitarios;39;17;9;8;37274
2020-04-24;Segovia;Todos;Otros sanitarios;2;1;1;0;40004
2020-04-24;Segovia;Todos;Personal en formación;28;11;2;9;40004
2020-04-24;Soria;Todos;Auxiliares sanitarios;85;24;11;13;42173
2020-04-24;Soria;Todos;Enfermero/a;192;70;29;41;42173
2020-04-24;Soria;Todos;Servicios de apoyo no sanitario;13;3;2;1;42173
2020-04-24;Valladolid;Todos;Administrativo;230;26;12;14;47186
2020-04-24;Valladolid;Todos;Celador;102;18;13;5;47186
2020-04-24;Valladolid;Todos;Fisioterapeuta;39;4;3;1;47186
2020-04-24;Zamora;Todos;Celador;31;3;1;2;49275
2020-04-24;Zamora;Todos;Fisioterapeuta;7;1;1;0;49275
2020-04-24;Zamora;Todos;Médicos;150;20;6;14;49275
2020-04-25;Ávila;Todos;Administrativo;27;16;12;4;5019
2020-04-25;Ávila;Todos;Médicos;206;69;43;26;5019
2020-04-25;Ávila;Todos;Otros;1;1;0;1;5019
2020-04-25;Burgos;Todos;Celador;74;14;5;9;9059
2020-04-25;Burgos;Todos;Otros;8;2;1;1;9059
2020-04-25;Burgos;Todos;Técnicos sanitarios;38;4;0;4;9059
2020-04-25;León;Todos;Auxiliares sanitarios;320;55;24;31;24089
2020-04-25;León;Todos;Celador;173;19;8;11;24089
2020-04-25;León;Todos;Fisioterapeuta;16;2;0;2;24089
2020-04-25;León;Todos;Otros sanitarios;24;3;0;3;24089
2020-04-25;León;Todos;Técnicos sanitarios;49;7;2;5;24089
2020-04-25;Palencia;Todos;Auxiliares sanitarios;62;15;10;5;34120
2020-04-25;Palencia;Todos;Personal en formación;18;6;1;5;34120
2020-04-25;Salamanca;Todos;Administrativo;57;21;10;11;37274
2020-04-25;Salamanca;Todos;Celador;67;25;12;13;37274
2020-04-25;Salamanca;Todos;Médicos;366;127;41;86;37274
2020-04-25;Salamanca;Todos;Personal en formación;86;29;15;14;37274
2020-04-25;Salamanca;Todos;Servicios de apoyo no sanitario;35;15;7;8;37274
2020-04-25;Segovia;Todos;Auxiliares sanitarios;138;48;19;29;40004
2020-04-25;Segovia;Todos;Celador;54;21;10;11;40004
2020-04-25;Segovia;Todos;Otros sanitarios;2;1;1;0;40004
2020-04-25;Segovia;Todos;Personal en formación;28;11;2;9;40004
2020-04-25;Soria;Todos;Administrativo;46;17;7;10;42173
2020-04-25;Soria;Todos;Fisioterapeuta;6;1;0;1;42173
2020-04-25;Soria;Todos;Otros sanitarios;6;3;2;1;42173
2020-04-25;Soria;Todos;Servicios de apoyo no sanitario;15;3;1;2;42173
2020-04-25;Valladolid;Todos;Auxiliares sanitarios;283;53;35;18;47186
2020-04-25;Valladolid;Todos;Fisioterapeuta;39;4;3;1;47186
2020-04-25;Valladolid;Todos;Médicos;826;113;36;77;47186
2020-04-25;Valladolid;Todos;Personal en formación;194;27;8;19;47186
2020-04-25;Zamora;Todos;Auxiliares sanitarios;69;6;5;1;49275
2020-04-25;Zamora;Todos;Celador;31;3;1;2;49275
2020-04-25;Zamora;Todos;Fisioterapeuta;7;1;1;0;49275
2020-04-25;Zamora;Todos;Otros;0;0;0;0;49275
2020-04-26;Ávila;Todos;Fisioterapeuta;7;0;0;0;5019
2020-04-26;Ávila;Todos;Médicos;216;69;43;26;5019
2020-04-26;Ávila;Todos;Otros sanitarios;10;5;5;0;5019
2020-04-26;Ávila;Todos;Personal en formación;20;4;2;2;5019
2020-04-26;Burgos;Todos;Auxiliares sanitarios;236;44;22;22;9059
2020-04-26;Burgos;Todos;Enfermero/a;568;76;28;48;9059
2020-04-26;Burgos;Todos;Médicos;440;59;22;37;9059
2020-04-26;Burgos;Todos;Personal en formación;42;4;0;4;9059
2020-04-26;Burgos;Todos;Servicios de apoyo no sanitario;19;3;2;1;9059
2020-04-26;Burgos;Todos;Técnicos sanitarios;38;4;0;4;9059
2020-04-26;León;Todos;Auxiliares sanitarios;320;55;24;31;24089
2020-04-26;León;Todos;Personal en formación;115;16;5;11;24089
2020-04-26;León;Todos;Servicios de apoyo no sanitario;17;3;1;2;24089
2020-04-26;Palencia;Todos;Auxiliares sanitarios;67;18;12;6;34120
2020-04-26;Palencia;Todos;Enfermero/a;189;42;26;16;34120
2020-04-26;Palencia;Todos;Otros;4;1;1;0;34120
2020-04-26;Palencia;Todos;Personal en formación;18;6;1;5;34120
2020-04-26;Salamanca;Todos;Otros sanitarios;8;4;3;1;37274
2020-04-26;Salamanca;Todos;Servicios de apoyo no sanitario;35;14;6;8;37274
2020-04-26;Segovia;Todos;Administrativo;56;18;7;11;40004
2020-04-26;Segovia;Todos;Enfermero/a;295;124;22;102;40004
2020-04-26;Segovia;Todos;Otros sanitarios;2;1;1;0;40004
2020-04-26;Segovia;Todos;Personal en formación;28;11;2;9;40004
2020-04-26;Segovia;Todos;Servicios de apoyo no sanitario;20;9;1;8;40004
2020-04-26;Soria;Todos;Administrativo;46;17;6;11;42173
2020-04-26;Soria;Todos;Auxiliares sanitarios;86;25;12;13;42173
2020-04-26;Soria;Todos;Enfermero/a;197;72;27;45;42173
2020-04-26;Soria;Todos;Fisioterapeuta;6;1;0;1;42173
2020-04-26;Soria;Todos;Otros sanitarios;6;3;2;1;42173
2020-04-26;Valladolid;Todos;Administrativo;237;26;11;15;47186
2020-04-26;Valladolid;Todos;Personal en formación;196;27;8;19;47186
2020-04-26;Zamora;Todos;Enfermero/a;145;21;14;7;49275
2020-04-26;Zamora;Todos;Otros;0;0;0;0;49275
2020-04-26;Zamora;Todos;Otros sanitarios;3;1;0;1;49275
2020-04-27;Ávila;Todos;Otros sanitarios;10;6;6;0;5019
2020-04-27;Ávila;Todos;Personal en formación;28;4;2;2;5019
2020-04-27;Burgos;Todos;Fisioterapeuta;20;2;1;1;9059
2020-04-27;Burgos;Todos;Médicos;457;59;21;38;9059
2020-04-27;León;Todos;Celador;215;20;9;11;24089
2020-04-27;León;Todos;Técnicos sanitarios;56;8;3;5;24089
2020-04-27;Palencia;Todos;Administrativo;59;5;3;2;34120
2020-04-27;Palencia;Todos;Auxiliares sanitarios;68;18;12;6;34120
2020-04-27;Palencia;Todos;Médicos;165;28;10;18;34120
2020-04-27;Palencia;Todos;Otros;4;1;1;0;34120
2020-04-27;Palencia;Todos;Otros sanitarios;7;1;0;1;34120
2020-04-27;Salamanca;Todos;Administrativo;58;22;11;11;37274
2020-04-27;Salamanca;Todos;Enfermero/a;440;124;51;73;37274
2020-04-27;Salamanca;Todos;Fisioterapeuta;6;4;1;3;37274
2020-04-27;Salamanca;Todos;Médicos;368;128;40;88;37274
2020-04-27;Salamanca;Todos;Otros sanitarios;8;4;3;1;37274
2020-04-27;Segovia;Todos;Celador;54;21;9;12;40004
2020-04-27;Soria;Todos;Celador;66;13;3;10;42173
2020-04-27;Soria;Todos;Servicios de apoyo no sanitario;17;4;2;2;42173
2020-04-27;Valladolid;Todos;Fisioterapeuta;39;4;2;2;47186
2020-04-27;Valladolid;Todos;Médicos;842;116;34;82;47186
2020-04-27;Valladolid;Todos;Otros;4;0;0;0;47186
2020-04-27;Valladolid;Todos;Técnicos sanitarios;84;10;5;5;47186
2020-04-27;Zamora;Todos;Celador;41;3;1;2;49275
2020-04-27;Zamora;Todos;Enfermero/a;171;25;17;8;49275
2020-04-27;Zamora;Todos;Personal en formación;15;1;1;0;49275
2020-04-28;Ávila;Todos;Administrativo;43;17;13;4;5019
2020-04-28;Ávila;Todos;Celador;97;11;10;1;5019
2020-04-28;Ávila;Todos;Enfermero/a;390;84;61;23;5019
2020-04-28;Ávila;Todos;Fisioterapeuta;13;0;0;0;5019
2020-04-28;Ávila;Todos;Técnicos sanitarios;26;7;6;1;5019
2020-04-28;Burgos;Todos;Administrativo;121;9;3;6;9059
2020-04-28;Burgos;Todos;Médicos;475;59;20;39;9059
2020-04-28;Burgos;Todos;Otros sanitarios;18;0;0;0;9059
2020-04-28;Burgos;Todos;Personal en formación;52;5;1;4;9059
2020-04-28;León;Todos;Celador;222;20;9;11;24089
2020-04-28;León;Todos;Enfermero/a;943;144;58;86;24089
2020-04-28;León;Todos;Otros;6;0;0;0;24089
2020-04-28;León;Todos;Personal en formación;128;16;4;12;24089
2020-04-28;Palencia;Todos;Auxiliares sanitarios;68;18;11;7;34120
2020-04-28;Palencia;Todos;Enfermero/a;189;43;24;19;34120
2020-04-28;Palencia;Todos;Médicos;167;29;10;19;34120
2020-04-28;Palencia;Todos;Personal en formación;18;6;0;6;34120
2020-04-28;Palencia;Todos;Servicios de apoyo no sanitario;14;3;1;2;34120
2020-04-28;Palencia;Todos;Técnicos sanitarios;9;3;2;1;34120
2020-04-28;Salamanca;Todos;Médicos;371;127;40;87;37274
2020-04-28;Salamanca;Todos;Personal en formación;88;29;14;15;37274
2020-04-28;Segovia;Todos;Celador;67;25;12;13;40004
2020-04-28;Segovia;Todos;Enfermero/a;338;129;24;105;40004
2020-04-28;Segovia;Todos;Médicos;244;82;17;65;40004
2020-04-28;Segovia;Todos;Otros sanitarios;4;2;1;1;40004
2020-04-28;Segovia;Todos;Servicios de apoyo no sanitario;21;9;1;8;40004
2020-04-28;Valladolid;Todos;Auxiliares sanitarios;307;54;29;25;47186
2020-04-28;Valladolid;Todos;Otros;4;0;0;0;47186
2020-04-28;Valladolid;Todos;Otros sanitarios;22;4;0;4;47186
2020-04-28;Valladolid;Todos;Personal en formación;200;26;7;19;47186
2020-04-28;Valladolid;Todos;Servicios de apoyo no sanitario;47;8;3;5;47186
2020-04-28;Zamora;Todos;Auxiliares sanitarios;109;6;5;1;49275
2020-04-28;Zamora;Todos;Celador;47;3;1;2;49275
2020-04-28;Zamora;Todos;Médicos;186;18;5;13;49275
2020-04-28;Zamora;Todos;Otros sanitarios;3;1;0;1;49275
2020-04-29;Ávila;Todos;Enfermero/a;432;88;65;23;5019
2020-04-29;Ávila;Todos;Fisioterapeuta;14;0;0;0;5019
2020-04-29;Ávila;Todos;Médicos;320;79;51;28;5019
2020-04-29;Burgos;Todos;Administrativo;122;9;3;6;9059
2020-04-29;Burgos;Todos;Enfermero/a;707;85;34;51;9059
2020-04-29;Burgos;Todos;Personal en formación;71;8;1;7;9059
2020-04-29;Burgos;Todos;Técnicos sanitarios;54;4;0;4;9059
2020-04-29;León;Todos;Administrativo;152;14;5;9;24089
2020-04-29;León;Todos;Enfermero/a;1029;146;57;89;24089
2020-04-29;León;Todos;Médicos;729;94;24;70;24089
2020-04-29;León;Todos;Otros sanitarios;28;3;0;3;24089
2020-04-29;León;Todos;Técnicos sanitarios;63;8;2;6;24089
2020-04-29;Palencia;Todos;Administrativo;59;5;3;2;34120
2020-04-29;Palencia;Todos;Fisioterapeuta;6;1;1;0;34120
2020-04-29;Palencia;Todos;Otros sanitarios;7;1;0;1;34120
2020-04-29;Palencia;Todos;Personal en formación;18;6;0;6;34120
2020-04-29;Salamanca;Todos;Fisioterapeuta;11;4;1;3;37274
2020-04-29;Salamanca;Todos;Médicos;495;135;45;90;37274
2020-04-29;Segovia;Todos;Administrativo;77;19;3;16;40004
2020-04-29;Segovia;Todos;Enfermero/a;395;135;35;100;40004
2020-04-29;Soria;Todos;Administrativo;63;18;5;13;42173
2020-04-29;Soria;Todos;Celador;79;14;3;11;42173
2020-04-29;Soria;Todos;Fisioterapeuta;8;1;0;1;42173
2020-04-29;Valladolid;Todos;Fisioterapeuta;40;4;2;2;47186
2020-04-29;Valladolid;Todos;Otros sanitarios;23;4;0;4;47186
2020-04-29;Valladolid;Todos;Técnicos sanitarios;91;11;4;7;47186
2020-04-29;Zamora;Todos;Enfermero/a;226;25;15;10;49275
2020-04-30;Ávila;Todos;Celador;106;13;10;3;5019
2020-04-30;Ávila;Todos;Otros;0;0;0;0;5019
2020-04-30;Ávila;Todos;Otros sanitarios;15;6;5;1;5019
2020-04-30;Ávila;Todos;Personal en formación;36;4;1;3;5019
2020-04-30;Burgos;Todos;Enfermero/a;746;85;33;52;9059
2020-04-30;Burgos;Todos;Médicos;528;62;21;41;9059
2020-04-30;Burgos;Todos;Otros sanitarios;19;0;0;0;9059
2020-04-30;Burgos;Todos;Personal en formación;84;8;1;7;9059
2020-04-30;Burgos;Todos;Técnicos sanitarios;58;4;0;4;9059
2020-04-30;León;Todos;Celador;235;20;9;11;24089
2020-04-30;León;Todos;Otros;6;0;0;0;24089
2020-04-30;León;Todos;Técnicos sanitarios;64;8;3;5;24089
2020-04-30;Palencia;Todos;Celador;34;12;4;8;34120
2020-04-30;Palencia;Todos;Fisioterapeuta;6;1;1;0;34120
2020-04-30;Palencia;Todos;Médicos;172;29;5;24;34120
2020-04-30;Salamanca;Todos;Fisioterapeuta;18;5;2;3;37274
2020-04-30;Salamanca;Todos;Médicos;586;140;43;97;37274
2020-04-30;Salamanca;Todos;Personal en formación;108;31;15;16;37274
2020-04-30;Salamanca;Todos;Servicios de apoyo no sanitario;37;14;4;10;37274
2020-04-30;Segovia;Todos;Administrativo;80;19;4;15;40004
2020-04-30;Segovia;Todos;Auxiliares sanitarios;199;58;15;43;40004
2020-04-30;Segovia;Todos;Enfermero/a;435;147;43;104;40004
2020-04-30;Segovia;Todos;Otros;0;0;0;0;40004
2020-04-30;Soria;Todos;Celador;84;14;3;11;42173
2020-04-30;Soria;Todos;Enfermero/a;289;83;30;53;42173
2020-04-30;Soria;Todos;Otros;0;0;0;0;42173
2020-04-30;Soria;Todos;Personal en formación;27;2;1;1;42173
2020-04-30;Valladolid;Todos;Administrativo;244;26;9;17;47186
2020-04-30;Valladolid;Todos;Celador;116;22;12;10;47186
2020-04-30;Valladolid;Todos;Enfermero/a;974;154;56;98;47186
2020-04-30;Valladolid;Todos;Fisioterapeuta;40;4;2;2;47186
2020-04-30;Valladolid;Todos;Otros;4;0;0;0;47186
2020-04-30;Valladolid;Todos;Servicios de apoyo no sanitario;50;8;3;5;47186
2020-04-30;Valladolid;Todos;Técnicos sanitarios;92;11;4;7;47186
2020-04-30;Zamora;Todos;Administrativo;44;5;3;2;49275
2020-04-30;Zamora;Todos;Auxiliares sanitarios;125;6;4;2;49275
2020-04-30;Zamora;Todos;Celador;56;4;2;2;49275
2020-04-30;Zamora;Todos;Médicos;240;19;8;11;49275
2020-04-30;Zamora;Todos;Otros;0;0;0;0;49275
2020-04-30;Zamora;Todos;Otros sanitarios;4;1;0;1;49275
2020-04-30;Zamora;Todos;Técnicos sanitarios;6;0;0;0;49275
2020-05-01;Ávila;Todos;Médicos;351;78;46;32;5019
2020-05-01;Ávila;Todos;Otros;0;0;0;0;5019
2020-05-01;Ávila;Todos;Personal en formación;36;4;1;3;5019
2020-05-01;Ávila;Todos;Técnicos sanitarios;37;8;7;1;5019
2020-05-01;Burgos;Todos;Administrativo;136;9;3;6;9059
2020-05-01;Burgos;Todos;Celador;95;16;5;11;9059
2020-05-01;Burgos;Todos;Enfermero/a;757;86;32;54;9059
2020-05-01;León;Todos;Auxiliares sanitarios;440;63;30;33;24089
2020-05-01;León;Todos;Enfermero/a;1090;149;53;96;24089
2020-05-01;León;Todos;Otros sanitarios;28;3;0;3;24089
2020-05-01;León;Todos;Servicios de apoyo no sanitario;19;3;1;2;24089
2020-05-01;Palencia;Todos;Enfermero/a;198;43;16;27;34120
2020-05-01;Palencia;Todos;Médicos;174;29;5;24;34120
2020-05-01;Palencia;Todos;Otros;4;1;1;0;34120
2020-05-01;Palencia;Todos;Personal en formación;19;6;0;6;34120
2020-05-01;Salamanca;Todos;Administrativo;132;24;12;12;37274
2020-05-01;Salamanca;Todos;Celador;87;25;7;18;37274
2020-05-01;Salamanca;Todos;Técnicos sanitarios;45;16;4;12;37274
2020-05-01;Segovia;Todos;Técnicos sanitarios;38;13;2;11;40004
2020-05-01;Soria;Todos;Otros sanitarios;8;3;2;1;42173
2020-05-01;Soria;Todos;Personal en formación;27;2;1;1;42173
2020-05-01;Valladolid;Todos;Administrativo;246;26;8;18;47186
2020-05-01;Valladolid;Todos;Fisioterapeuta;40;4;2;2;47186
2020-05-01;Valladolid;Todos;Servicios de apoyo no sanitario;50;8;3;5;47186
2020-05-01;Valladolid;Todos;Técnicos sanitarios;94;11;4;7;47186
2020-05-01;Zamora;Todos;Celador;56;4;2;2;49275
2020-05-01;Zamora;Todos;Fisioterapeuta;13;1;1;0;49275
2020-05-01;Zamora;Todos;Técnicos sanitarios;7;0;0;0;49275
2020-05-02;Ávila;Todos;Auxiliares sanitarios;204;46;31;15;5019
2020-05-02;Ávila;Todos;Médicos;355;80;45;35;5019
2020-05-02;Burgos;Todos;Administrativo;136;9;3;6;9059
2020-05-02;Burgos;Todos;Celador;96;16;5;11;9059
2020-05-02;Burgos;Todos;Servicios de apoyo no sanitario;27;3;2;1;9059
2020-05-02;León;Todos;Médicos;753;97;20;77;24089
2020-05-02;León;Todos;Otros;6;0;0;0;24089
2020-05-02;León;Todos;Otros sanitarios;29;3;0;3;24089
2020-05-02;León;Todos;Servicios de apoyo no sanitario;19;3;1;2;24089
2020-05-02;Palencia;Todos;Auxiliares sanitarios;78;18;7;11;34120
2020-05-02;Palencia;Todos;Servicios de apoyo no sanitario;14;3;1;2;34120
2020-05-02;Palencia;Todos;Técnicos sanitarios;9;3;1;2;34120
2020-05-02;Salamanca;Todos;Administrativo;132;24;12;12;37274
2020-05-02;Salamanca;Todos;Auxiliares sanitarios;256;86;28;58;37274
2020-05-02;Salamanca;Todos;Otros;4;3;2;1;37274
2020-05-02;Salamanca;Todos;Otros sanitarios;15;4;3;1;37274
2020-05-02;Segovia;Todos;Celador;105;29;10;19;40004
2020-05-02;Segovia;Todos;Fisioterapeuta;8;2;1;1;40004
2020-05-02;Segovia;Todos;Personal en formación;48;17;5;12;40004
2020-05-02;Segovia;Todos;Técnicos sanitarios;39;13;2;11;40004
2020-05-02;Soria;Todos;Enfermero/a;291;85;26;59;42173
2020-05-02;Soria;Todos;Médicos;222;64;18;46;42173
2020-05-02;Soria;Todos;Personal en formación;27;2;1;1;42173
2020-05-02;Soria;Todos;Técnicos sanitarios;30;8;2;6;42173
2020-05-02;Valladolid;Todos;Auxiliares sanitarios;339;56;21;35;47186
2020-05-02;Valladolid;Todos;Enfermero/a;992;156;51;105;47186
2020-05-02;Valladolid;Todos;Otros;4;0;0;0;47186
2020-05-02;Valladolid;Todos;Otros sanitarios;23;4;0;4;47186
2020-05-02;Valladolid;Todos;Técnicos sanitarios;94;11;4;7;47186
2020-05-02;Zamora;Todos;Administrativo;45;5;2;3;49275
2020-05-02;Zamora;Todos;Auxiliares sanitarios;126;6;4;2;49275
2020-05-02;Zamora;Todos;Enfermero/a;291;27;13;14;49275
2020-05-02;Zamora;Todos;Fisioterapeuta;13;1;1;0;49275
2020-05-02;Zamora;Todos;Servicios de apoyo no sanitario;2;0;0;0;49275
2020-05-03;Ávila;Todos;Fisioterapeuta;14;0;0;0;5019
2020-05-03;Ávila;Todos;Otros;0;0;0;0;5019
2020-05-03;Ávila;Todos;Servicios de apoyo no sanitario;25;9;8;1;5019
2020-05-03;Burgos;Todos;Médicos;539;64;20;44;9059
2020-05-03;Burgos;Todos;Servicios de apoyo no sanitario;27;3;2;1;9059
2020-05-03;León;Todos;Enfermero/a;1101;149;50;99;24089
2020-05-03;Palencia;Todos;Otros;5;1;1;0;34120
2020-05-03;Palencia;Todos;Técnicos sanitarios;9;3;1;2;34120
2020-05-03;Salamanca;Todos;Auxiliares sanitarios;256;87;29;58;37274
2020-05-03;Salamanca;Todos;Fisioterapeuta;20;6;3;3;37274
2020-05-03;Salamanca;Todos;Médicos;602;142;42;100;37274
2020-05-03;Segovia;Todos;Administrativo;80;19;4;15;40004
2020-05-03;Segovia;Todos;Auxiliares sanitarios;201;58;13;45;40004
2020-05-03;Segovia;Todos;Celador;105;29;10;19;40004
2020-05-03;Segovia;Todos;Enfermero/a;441;149;38;111;40004
2020-05-03;Segovia;Todos;Otros sanitarios;7;4;2;2;40004
2020-05-03;Segovia;Todos;Personal en formación;48;17;5;12;40004
2020-05-03;Soria;Todos;Auxiliares sanitarios;136;29;11;18;42173
2020-05-03;Soria;Todos;Enfermero/a;292;85;26;59;42173
2020-05-03;Soria;Todos;Fisioterapeuta;8;1;0;1;42173
2020-05-03;Soria;Todos;Técnicos sanitarios;30;8;2;6;42173
2020-05-03;Valladolid;Todos;Auxiliares sanitarios;340;57;22;35;47186
2020-05-03;Valladolid;Todos;Celador;119;23;9;14;47186
2020-05-03;Valladolid;Todos;Fisioterapeuta;40;4;2;2;47186
2020-05-03;Valladolid;Todos;Servicios de apoyo no sanitario;51;8;3;5;47186
2020-05-03;Zamora;Todos;Administrativo;45;5;2;3;49275
2020-05-03;Zamora;Todos;Enfermero/a;292;27;13;14;49275
2020-05-03;Zamora;Todos;Médicos;251;22;10;12;49275
2020-05-03;Zamora;Todos;Otros sanitarios;4;1;0;1;49275
2020-05-04;Ávila;Todos;Administrativo;59;19;15;4;5019
2020-05-04;Ávila;Todos;Auxiliares sanitarios;228;48;32;16;5019
2020-05-04;Ávila;Todos;Celador;109;13;10;3;5019
2020-05-04;Ávila;Todos;Técnicos sanitarios;45;9;5;4;5019
2020-05-04;Burgos;Todos;Administrativo;138;9;3;6;9059
2020-05-04;Burgos;Todos;Celador;96;16;3;13;9059
2020-05-04;Burgos;Todos;Otros;11;2;1;1;9059
2020-05-04;Burgos;Todos;Otros sanitarios;19;0;0;0;9059
2020-05-04;Burgos;Todos;Servicios de apoyo no sanitario;27;3;2;1;9059
2020-05-04;Burgos;Todos;Técnicos sanitarios;63;5;1;4;9059
2020-05-04;León;Todos;Administrativo;156;15;5;10;24089
2020-05-04;León;Todos;Auxiliares sanitarios;455;64;28;36;24089
2020-05-04;León;Todos;Celador;237;21;10;11;24089
2020-05-04;León;Todos;Fisioterapeuta;30;2;1;1;24089
2020-05-04;León;Todos;Otros sanitarios;29;3;0;3;24089
2020-05-04;León;Todos;Personal en formación;150;17;3;14;24089
2020-05-04;León;Todos;Servicios de apoyo no sanitario;21;3;1;2;24089
2020-05-04;León;Todos;Técnicos sanitarios;67;8;3;5;24089
2020-05-04;Palencia;Todos;Celador;34;12;2;10;34120
2020-05-04;Palencia;Todos;Fisioterapeuta;7;2;1;1;34120
2020-05-04;Palencia;Todos;Médicos;177;29;5;24;34120
2020-05-04;Palencia;Todos;Otros;5;1;1;0;34120
2020-05-04;Palencia;Todos;Técnicos sanitarios;10;3;1;2;34120
2020-05-04;Salamanca;Todos;Enfermero/a;707;145;49;96;37274
2020-05-04;Segovia;Todos;Administrativo;96;20;8;12;40004
2020-05-04;Segovia;Todos;Celador;118;33;17;16;40004
2020-05-04;Segovia;Todos;Enfermero/a;477;156;44;112;40004
2020-05-04;Segovia;Todos;Otros sanitarios;9;4;2;2;40004
2020-05-04;Segovia;Todos;Personal en formación;53;18;6;12;40004
2020-05-04;Soria;Todos;Administrativo;83;18;5;13;42173
2020-05-04;Valladolid;Todos;Personal en formación;198;23;4;19;47186
2020-05-04;Valladolid;Todos;Servicios de apoyo no sanitario;51;8;4;4;47186
2020-05-04;Valladolid;Todos;Técnicos sanitarios;97;11;4;7;47186
2020-05-04;Zamora;Todos;Celador;56;4;2;2;49275
2020-05-04;Zamora;Todos;Enfermero/a;306;30;15;15;49275
2020-05-04;Zamora;Todos;Médicos;269;22;11;11;49275
2020-05-05;Ávila;Todos;Celador;109;13;10;3;5019
2020-05-05;Ávila;Todos;Personal en formación;36;4;1;3;5019
2020-05-05;Burgos;Todos;Auxiliares sanitarios;440;55;20;35;9059
2020-05-05;Burgos;Todos;Otros;11;2;1;1;9059
2020-05-05;Burgos;Todos;Personal en formación;91;8;1;7;9059
2020-05-05;Burgos;Todos;Técnicos sanitarios;63;5;1;4;9059
2020-05-05;León;Todos;Administrativo;157;15;5;10;24089
2020-05-05;León;Todos;Técnicos sanitarios;64;7;3;4;24089
2020-05-05;Palencia;Todos;Administrativo;63;5;1;4;34120
2020-05-05;Palencia;Todos;Enfermero/a;206;44;10;34;34120
2020-05-05;Palencia;Todos;Otros sanitarios;7;1;0;1;34120
2020-05-05;Palencia;Todos;Técnicos sanitarios;11;3;1;2;34120
2020-05-05;Salamanca;Todos;Auxiliares sanitarios;257;87;29;58;37274
2020-05-05;Salamanca;Todos;Celador;93;25;6;19;37274
2020-05-05;Salamanca;Todos;Enfermero/a;724;143;49;94;37274
2020-05-05;Salamanca;Todos;Fisioterapeuta;23;6;3;3;37274
2020-05-05;Salamanca;Todos;Médicos;632;145;49;96;37274
2020-05-05;Salamanca;Todos;Otros;4;3;2;1;37274
2020-05-05;Salamanca;Todos;Servicios de apoyo no sanitario;40;14;2;12;37274
2020-05-05;Segovia;Todos;Celador;130;35;15;20;40004
2020-05-05;Segovia;Todos;Fisioterapeuta;8;2;1;1;40004
2020-05-05;Segovia;Todos;Personal en formación;59;18;5;13;40004
2020-05-05;Segovia;Todos;Servicios de apoyo no sanitario;26;9;0;9;40004
2020-05-05;Segovia;Todos;Técnicos sanitarios;41;13;3;10;40004
2020-05-05;Soria;Todos;Auxiliares sanitarios;180;40;15;25;42173
2020-05-05;Soria;Todos;Médicos;247;68;21;47;42173
2020-05-05;Soria;Todos;Personal en formación;27;2;1;1;42173
2020-05-05;Valladolid;Todos;Administrativo;260;27;11;16;47186
2020-05-05;Valladolid;Todos;Celador;121;23;9;14;47186
2020-05-05;Valladolid;Todos;Fisioterapeuta;43;4;1;3;47186
2020-05-05;Valladolid;Todos;Otros sanitarios;24;4;1;3;47186
2020-05-05;Zamora;Todos;Celador;56;4;1;3;49275
2020-05-05;Zamora;Todos;Fisioterapeuta;14;1;1;0;49275
2020-05-05;Zamora;Todos;Médicos;281;22;11;11;49275
2020-05-05;Zamora;Todos;Otros;0;0;0;0;49275
2020-05-05;Zamora;Todos;Otros sanitarios;6;1;0;1;49275
2020-05-05;Zamora;Todos;Servicios de apoyo no sanitario;1;0;0;0;49275
2020-05-06;Ávila;Todos;Administrativo;61;20;16;4;5019
2020-05-06;Burgos;Todos;Administrativo;142;10;2;8;9059
2020-05-06;Burgos;Todos;Otros;11;2;1;1;9059
2020-05-06;Burgos;Todos;Personal en formación;91;8;1;7;9059
2020-05-06;León;Todos;Médicos;783;100;18;82;24089
2020-05-06;León;Todos;Otros sanitarios;29;3;0;3;24089
2020-05-06;León;Todos;Personal en formación;167;17;3;14;24089
2020-05-06;León;Todos;Servicios de apoyo no sanitario;25;3;1;2;24089
2020-05-06;León;Todos;Técnicos sanitarios;66;7;3;4;24089
2020-05-06;Palencia;Todos;Médicos;184;31;5;26;34120
2020-05-06;Palencia;Todos;Otros;5;1;1;0;34120
2020-05-06;Palencia;Todos;Personal en formación;21;6;0;6;34120
2020-05-06;Palencia;Todos;Técnicos sanitarios;12;3;0;3;34120
2020-05-06;Salamanca;Todos;Administrativo;168;26;12;14;37274
2020-05-06;Salamanca;Todos;Auxiliares sanitarios;262;89;29;60;37274
2020-05-06;Salamanca;Todos;Enfermero/a;732;144;46;98;37274
2020-05-06;Salamanca;Todos;Personal en formación;125;32;12;20;37274
2020-05-06;Segovia;Todos;Auxiliares sanitarios;270;74;30;44;40004
2020-05-06;Segovia;Todos;Fisioterapeuta;8;2;1;1;40004
2020-05-06;Segovia;Todos;Servicios de apoyo no sanitario;27;9;0;9;40004
2020-05-06;Segovia;Todos;Técnicos sanitarios;42;13;2;11;40004
2020-05-06;Soria;Todos;Enfermero/a;383;93;29;64;42173
2020-05-06;Soria;Todos;Fisioterapeuta;8;2;0;2;42173
2020-05-06;Soria;Todos;Otros;0;0;0;0;42173
2020-05-06;Soria;Todos;Otros sanitarios;10;3;3;0;42173
2020-05-06;Soria;Todos;Servicios de apoyo no sanitario;62;7;2;5;42173
2020-05-06;Valladolid;Todos;Administrativo;268;31;10;21;47186
2020-05-06;Valladolid;Todos;Personal en formación;208;25;6;19;47186
2020-05-06;Zamora;Todos;Administrativo;49;4;1;3;49275
2020-05-06;Zamora;Todos;Auxiliares sanitarios;125;9;5;4;49275
2020-05-06;Zamora;Todos;Médicos;294;22;11;11;49275
2020-05-06;Zamora;Todos;Técnicos sanitarios;11;1;1;0;49275
2020-05-07;Ávila;Todos;Auxiliares sanitarios;238;50;35;15;5019
2020-05-07;Ávila;Todos;Fisioterapeuta;14;0;0;0;5019
2020-05-07;Burgos;Todos;Celador;167;20;5;15;9059
2020-05-07;León;Todos;Administrativo;160;18;6;12;24089
2020-05-07;León;Todos;Personal en formación;168;18;4;14;24089
2020-05-07;León;Todos;Servicios de apoyo no sanitario;26;3;1;2;24089
2020-05-07;León;Todos;Técnicos sanitarios;71;7;3;4;24089
2020-05-07;Palencia;Todos;Auxiliares sanitarios;99;19;7;12;34120
2020-05-07;Palencia;Todos;Fisioterapeuta;12;2;1;1;34120
2020-05-07;Palencia;Todos;Otros sanitarios;9;2;0;2;34120
2020-05-07;Salamanca;Todos;Celador;100;25;6;19;37274
2020-05-07;Salamanca;Todos;Fisioterapeuta;23;6;2;4;37274
2020-05-07;Salamanca;Todos;Otros;7;4;3;1;37274
2020-05-07;Segovia;Todos;Enfermero/a;585;174;72;102;40004
2020-05-07;Segovia;Todos;Médicos;379;106;34;72;40004
2020-05-07;Segovia;Todos;Técnicos sanitarios;61;15;5;10;40004
2020-05-07;Soria;Todos;Personal en formación;32;3;2;1;42173
2020-05-07;Soria;Todos;Servicios de apoyo no sanitario;65;7;2;5;42173
2020-05-07;Soria;Todos;Técnicos sanitarios;47;11;3;8;42173
2020-05-07;Valladolid;Todos;Administrativo;271;30;12;18;47186
2020-05-07;Valladolid;Todos;Otros sanitarios;25;4;0;4;47186
2020-05-07;Valladolid;Todos;Técnicos sanitarios;93;13;5;8;47186
2020-05-07;Zamora;Todos;Administrativo;54;4;1;3;49275
2020-05-07;Zamora;Todos;Celador;61;5;1;4;49275
2020-05-07;Zamora;Todos;Personal en formación;22;0;0;0;49275
2020-05-07;Zamora;Todos;Servicios de apoyo no sanitario;2;0;0;0;49275
2020-05-08;Ávila;Todos;Enfermero/a;519;92;58;34;5019
2020-05-08;Ávila;Todos;Médicos;371;83;46;37;5019
2020-05-08;Ávila;Todos;Servicios de apoyo no sanitario;32;11;9;2;5019
2020-05-08;Ávila;Todos;Técnicos sanitarios;45;10;6;4;5019
2020-05-08;Burgos;Todos;Administrativo;162;11;3;8;9059
2020-05-08;Burgos;Todos;Otros;11;2;1;1;9059
2020-05-08;Burgos;Todos;Personal en formación;110;9;1;8;9059
2020-05-08;León;Todos;Celador;259;21;12;9;24089
2020-05-08;León;Todos;Fisioterapeuta;31;2;1;1;24089
2020-05-08;León;Todos;Servicios de apoyo no sanitario;26;3;0;3;24089
2020-05-08;Palencia;Todos;Fisioterapeuta;12;2;1;1;34120
2020-05-08;Salamanca;Todos;Fisioterapeuta;24;6;2;4;37274
2020-05-08;Salamanca;Todos;Personal en formación;126;34;11;23;37274
2020-05-08;Segovia;Todos;Celador;172;42;15;27;40004
2020-05-08;Segovia;Todos;Enfermero/a;599;176;77;99;40004
2020-05-08;Segovia;Todos;Otros;0;0;0;0;40004
2020-05-08;Segovia;Todos;Personal en formación;71;22;9;13;40004
2020-05-08;Segovia;Todos;Servicios de apoyo no sanitario;31;11;2;9;40004
2020-05-08;Soria;Todos;Administrativo;103;21;6;15;42173
2020-05-08;Soria;Todos;Celador;105;15;2;13;42173
2020-05-08;Soria;Todos;Otros sanitarios;14;3;3;0;42173
2020-05-08;Soria;Todos;Personal en formación;33;3;2;1;42173
2020-05-08;Soria;Todos;Servicios de apoyo no sanitario;71;7;2;5;42173
2020-05-08;Soria;Todos;Técnicos sanitarios;57;12;4;8;42173
2020-05-08;Valladolid;Todos;Auxiliares sanitarios;335;63;22;41;47186
2020-05-08;Valladolid;Todos;Enfermero/a;1020;152;39;113;47186
2020-05-08;Valladolid;Todos;Fisioterapeuta;40;4;2;2;47186
2020-05-08;Valladolid;Todos;Técnicos sanitarios;88;12;4;8;47186
2020-05-08;Zamora;Todos;Administrativo;58;6;1;5;49275
2020-05-08;Zamora;Todos;Celador;63;6;1;5;49275
2020-05-08;Zamora;Todos;Médicos;310;24;13;11;49275
2020-05-08;Zamora;Todos;Personal en formación;23;0;0;0;49275
2020-05-08;Zamora;Todos;Técnicos sanitarios;13;1;0;1;49275
2020-05-09;Ávila;Todos;Administrativo;35;18;13;5;5019
2020-05-09;Ávila;Todos;Celador;106;14;7;7;5019
2020-05-09;Ávila;Todos;Otros sanitarios;10;6;4;2;5019
2020-05-09;Burgos;Todos;Celador;79;21;3;18;9059
2020-05-09;Burgos;Todos;Personal en formación;49;6;1;5;9059
2020-05-09;León;Todos;Administrativo;71;16;1;15;24089
2020-05-09;León;Todos;Enfermero/a;761;147;26;121;24089
2020-05-09;León;Todos;Servicios de apoyo no sanitario;28;3;0;3;24089
2020-05-09;Palencia;Todos;Administrativo;18;9;1;8;34120
2020-05-09;Palencia;Todos;Celador;32;14;2;12;34120
2020-05-09;Palencia;Todos;Fisioterapeuta;4;2;1;1;34120
2020-05-09;Palencia;Todos;Otros;3;1;1;0;34120
2020-05-09;Palencia;Todos;Técnicos sanitarios;10;3;0;3;34120
2020-05-09;Salamanca;Todos;Auxiliares sanitarios;245;86;21;65;37274
2020-05-09;Salamanca;Todos;Médicos;364;143;21;122;37274
2020-05-09;Salamanca;Todos;Servicios de apoyo no sanitario;39;14;3;11;37274
2020-05-09;Segovia;Todos;Fisioterapeuta;4;1;0;1;40004
2020-05-09;Segovia;Todos;Servicios de apoyo no sanitario;24;11;1;10;40004
2020-05-09;Soria;Todos;Médicos;107;66;7;59;42173
2020-05-09;Soria;Todos;Técnicos sanitarios;14;10;0;10;42173
2020-05-09;Valladolid;Todos;Celador;106;26;7;19;47186
2020-05-09;Valladolid;Todos;Enfermero/a;841;169;23;146;47186
2020-05-09;Valladolid;Todos;Fisioterapeuta;20;4;0;4;47186
2020-05-09;Valladolid;Todos;Médicos;599;125;10;115;47186
2020-05-09;Valladolid;Todos;Otros sanitarios;18;4;0;4;47186
2020-05-09;Valladolid;Todos;Técnicos sanitarios;84;13;0;13;47186
2020-05-09;Zamora;Todos;Administrativo;14;7;0;7;49275
2020-05-09;Zamora;Todos;Auxiliares sanitarios;39;13;2;11;49275
2020-05-09;Zamora;Todos;Médicos;105;24;1;23;49275
2020-05-09;Zamora;Todos;Otros;0;0;0;0;49275
2020-05-09;Zamora;Todos;Otros sanitarios;3;1;0;1;49275
2020-05-10;Ávila;Todos;Enfermero/a;385;100;61;39;5019
2020-05-10;Ávila;Todos;Otros sanitarios;10;6;4;2;5019
2020-05-10;Burgos;Todos;Administrativo;60;9;0;9;9059
2020-05-10;Burgos;Todos;Fisioterapeuta;9;2;1;1;9059
2020-05-10;Burgos;Todos;Otros sanitarios;15;0;0;0;9059
2020-05-10;Burgos;Todos;Personal en formación;49;6;1;5;9059
2020-05-10;Burgos;Todos;Técnicos sanitarios;65;5;1;4;9059
2020-05-10;León;Todos;Otros;5;0;0;0;24089
2020-05-10;Palencia;Todos;Celador;32;14;2;12;34120
2020-05-10;Palencia;Todos;Médicos;123;32;2;30;34120
2020-05-10;Palencia;Todos;Personal en formación;21;7;1;6;34120
2020-05-10;Salamanca;Todos;Auxiliares sanitarios;245;86;21;65;37274
2020-05-10;Salamanca;Todos;Celador;80;25;5;20;37274
2020-05-10;Salamanca;Todos;Enfermero/a;434;137;29;108;37274
2020-05-10;Salamanca;Todos;Médicos;364;143;21;122;37274
2020-05-10;Segovia;Todos;Auxiliares sanitarios;159;78;2;76;40004
2020-05-10;Segovia;Todos;Fisioterapeuta;4;1;0;1;40004
2020-05-10;Segovia;Todos;Otros;0;0;0;0;40004
2020-05-10;Segovia;Todos;Personal en formación;39;21;1;20;40004
2020-05-10;Segovia;Todos;Servicios de apoyo no sanitario;24;10;1;9;40004
2020-05-10;Soria;Todos;Administrativo;30;20;3;17;42173
2020-05-10;Soria;Todos;Médicos;107;66;7;59;42173
2020-05-10;Valladolid;Todos;Servicios de apoyo no sanitario;70;12;1;11;47186
2020-05-10;Zamora;Todos;Celador;19;7;0;7;49275
2020-05-10;Zamora;Todos;Fisioterapeuta;2;1;0;1;49275
2020-05-10;Zamora;Todos;Médicos;106;24;1;23;49275
2020-05-10;Zamora;Todos;Servicios de apoyo no sanitario;3;0;0;0;49275
2020-05-11;Ávila;Todos;Auxiliares sanitarios;226;56;32;24;5019
2020-05-11;Ávila;Todos;Otros;1;1;0;1;5019
2020-05-11;Ávila;Todos;Técnicos sanitarios;32;12;4;8;5019
2020-05-11;Burgos;Todos;Celador;87;22;2;20;9059
2020-05-11;Burgos;Todos;Enfermero/a;637;101;10;91;9059
2020-05-11;Burgos;Todos;Personal en formación;49;6;1;5;9059
2020-05-11;León;Todos;Auxiliares sanitarios;416;74;15;59;24089
2020-05-11;León;Todos;Celador;138;23;6;17;24089
2020-05-11;León;Todos;Enfermero/a;767;147;25;122;24089
2020-05-11;León;Todos;Fisioterapeuta;19;2;1;1;24089
2020-05-11;León;Todos;Médicos;499;98;6;92;24089
2020-05-11;Palencia;Todos;Celador;32;14;2;12;34120
2020-05-11;Palencia;Todos;Fisioterapeuta;4;2;1;1;34120
2020-05-11;Palencia;Todos;Otros;3;1;1;0;34120
2020-05-11;Salamanca;Todos;Auxiliares sanitarios;248;86;20;66;37274
2020-05-11;Salamanca;Todos;Enfermero/a;439;137;28;109;37274
2020-05-11;Salamanca;Todos;Médicos;367;143;19;124;37274
2020-05-11;Salamanca;Todos;Otros sanitarios;7;4;3;1;37274
2020-05-11;Segovia;Todos;Enfermero/a;327;163;5;158;40004
2020-05-11;Segovia;Todos;Otros sanitarios;5;3;1;2;40004
2020-05-11;Segovia;Todos;Personal en formación;41;21;1;20;40004
2020-05-11;Soria;Todos;Otros;0;0;0;0;42173
2020-05-11;Soria;Todos;Otros sanitarios;4;2;0;2;42173
2020-05-11;Soria;Todos;Personal en formación;9;2;1;1;42173
2020-05-11;Soria;Todos;Servicios de apoyo no sanitario;11;8;0;8;42173
2020-05-11;Soria;Todos;Técnicos sanitarios;14;10;0;10;42173
2020-05-11;Valladolid;Todos;Auxiliares sanitarios;390;68;16;52;47186
2020-05-11;Valladolid;Todos;Otros sanitarios;18;4;0;4;47186
2020-05-11;Zamora;Todos;Auxiliares sanitarios;42;14;2;12;49275
2020-05-11;Zamora;Todos;Celador;19;7;0;7;49275
2020-05-12;Ávila;Todos;Administrativo;35;18;13;5;5019
2020-05-12;Ávila;Todos;Auxiliares sanitarios;226;55;30;25;5019
2020-05-12;Ávila;Todos;Enfermero/a;389;102;60;42;5019
2020-05-12;Ávila;Todos;Otros sanitarios;10;6;3;3;5019
2020-05-12;Ávila;Todos;Personal en formación;27;4;3;1;5019
2020-05-12;Ávila;Todos;Servicios de apoyo no sanitario;29;11;6;5;5019
2020-05-12;Burgos;Todos;Administrativo;62;10;0;10;9059
2020-05-12;Burgos;Todos;Celador;88;22;2;20;9059
2020-05-12;Burgos;Todos;Enfermero/a;647;106;8;98;9059
2020-05-12;Burgos;Todos;Fisioterapeuta;9;2;1;1;9059
2020-05-12;Burgos;Todos;Técnicos sanitarios;72;7;0;7;9059
2020-05-12;León;Todos;Médicos;508;98;4;94;24089
2020-05-12;León;Todos;Servicios de apoyo no sanitario;32;4;1;3;24089
2020-05-12;Palencia;Todos;Auxiliares sanitarios;86;20;3;17;34120
2020-05-12;Palencia;Todos;Fisioterapeuta;4;2;1;1;34120
2020-05-12;Palencia;Todos;Otros;3;1;1;0;34120
2020-05-12;Palencia;Todos;Otros sanitarios;6;2;0;2;34120
2020-05-12;Palencia;Todos;Personal en formación;21;7;1;6;34120
2020-05-12;Salamanca;Todos;Administrativo;67;23;7;16;37274
2020-05-12;Salamanca;Todos;Técnicos sanitarios;42;17;1;16;37274
2020-05-12;Segovia;Todos;Celador;75;40;1;39;40004
2020-05-12;Segovia;Todos;Otros;0;0;0;0;40004
2020-05-12;Segovia;Todos;Otros sanitarios;5;3;1;2;40004
2020-05-12;Segovia;Todos;Servicios de apoyo no sanitario;24;12;1;11;40004
2020-05-12;Soria;Todos;Médicos;109;67;7;60;42173
2020-05-12;Soria;Todos;Otros;0;0;0;0;42173
2020-05-12;Valladolid;Todos;Administrativo;148;33;3;30;47186
2020-05-12;Valladolid;Todos;Fisioterapeuta;20;4;0;4;47186
2020-05-12;Valladolid;Todos;Médicos;610;125;9;116;47186
2020-05-12;Valladolid;Todos;Otros;5;0;0;0;47186
2020-05-12;Valladolid;Todos;Otros sanitarios;18;4;0;4;47186
2020-05-12;Zamora;Todos;Administrativo;17;8;0;8;49275
2020-05-12;Zamora;Todos;Técnicos sanitarios;8;1;0;1;49275
2020-05-13;Ávila;Todos;Celador;110;9;6;3;5019
2020-05-13;Ávila;Todos;Servicios de apoyo no sanitario;29;8;6;2;5019
2020-05-13;Ávila;Todos;Técnicos sanitarios;32;5;4;1;5019
2020-05-13;Burgos;Todos;Enfermero/a;657;80;8;72;9059
2020-05-13;León;Todos;Administrativo;124;8;1;7;24089
2020-05-13;León;Todos;Celador;183;16;4;12;24089
2020-05-13;León;Todos;Médicos;517;78;3;75;24089
2020-05-13;León;Todos;Personal en formación;127;15;2;13;24089
2020-05-13;León;Todos;Técnicos sanitarios;50;6;1;5;24089
2020-05-13;Palencia;Todos;Fisioterapeuta;4;2;1;1;34120
2020-05-13;Palencia;Todos;Servicios de apoyo no sanitario;11;3;0;3;34120
2020-05-13;Salamanca;Todos;Administrativo;68;20;7;13;37274
2020-05-13;Salamanca;Todos;Auxiliares sanitarios;254;79;19;60;37274
2020-05-13;Salamanca;Todos;Enfermero/a;443;118;25;93;37274
2020-05-13;Salamanca;Todos;Otros;4;2;1;1;37274
2020-05-13;Salamanca;Todos;Otros sanitarios;7;4;3;1;37274
2020-05-13;Salamanca;Todos;Servicios de apoyo no sanitario;42;12;3;9;37274
2020-05-13;Salamanca;Todos;Técnicos sanitarios;42;16;1;15;37274
2020-05-13;Segovia;Todos;Auxiliares sanitarios;164;49;1;48;40004
2020-05-13;Segovia;Todos;Fisioterapeuta;4;1;0;1;40004
2020-05-13;Segovia;Todos;Médicos;239;75;9;66;40004
2020-05-13;Segovia;Todos;Personal en formación;41;13;1;12;40004
2020-05-13;Segovia;Todos;Servicios de apoyo no sanitario;26;10;1;9;40004
2020-05-13;Soria;Todos;Administrativo;41;14;6;8;42173
2020-05-13;Soria;Todos;Otros;0;0;0;0;42173
2020-05-13;Soria;Todos;Técnicos sanitarios;14;8;0;8;42173
2020-05-13;Valladolid;Todos;Enfermero/a;876;148;19;129;47186
2020-05-13;Valladolid;Todos;Médicos;614;99;9;90;47186
2020-05-13;Zamora;Todos;Administrativo;19;1;0;1;49275
2020-05-13;Zamora;Todos;Otros;0;0;0;0;49275
2020-05-13;Zamora;Todos;Personal en formación;7;0;0;0;49275
2020-05-14;Ávila;Todos;Celador;110;9;6;3;5019
2020-05-14;Ávila;Todos;Médicos;247;67;33;34;5019
2020-05-14;Burgos;Todos;Enfermero/a;663;80;7;73;9059
2020-05-14;Burgos;Todos;Personal en formación;50;5;0;5;9059
2020-05-14;Burgos;Todos;Técnicos sanitarios;76;5;0;5;9059
2020-05-14;León;Todos;Auxiliares sanitarios;497;56;8;48;24089
2020-05-14;Palencia;Todos;Médicos;131;30;3;27;34120
2020-05-14;Palencia;Todos;Otros;3;1;1;0;34120
2020-05-14;Palencia;Todos;Otros sanitarios;6;1;0;1;34120
2020-05-14;Salamanca;Todos;Celador;89;23;5;18;37274
2020-05-14;Salamanca;Todos;Enfermero/a;448;119;24;95;37274
2020-05-14;Salamanca;Todos;Fisioterapeuta;12;5;1;4;37274
2020-05-14;Salamanca;Todos;Personal en formación;87;24;7;17;37274
2020-05-14;Segovia;Todos;Celador;82;21;1;20;40004
2020-05-14;Segovia;Todos;Enfermero/a;333;122;4;118;40004
2020-05-14;Segovia;Todos;Técnicos sanitarios;33;13;0;13;40004
2020-05-14;Soria;Todos;Celador;25;9;0;9;42173
2020-05-14;Soria;Todos;Enfermero/a;161;64;11;53;42173
2020-05-14;Soria;Todos;Fisioterapeuta;4;1;0;1;42173
2020-05-14;Soria;Todos;Otros;0;0;0;0;42173
2020-05-14;Soria;Todos;Servicios de apoyo no sanitario;12;2;0;2;42173
2020-05-14;Soria;Todos;Técnicos sanitarios;14;8;0;8;42173
2020-05-14;Valladolid;Todos;Enfermero/a;883;148;15;133;47186
2020-05-14;Valladolid;Todos;Fisioterapeuta;23;3;0;3;47186
2020-05-14;Valladolid;Todos;Otros;5;0;0;0;47186
2020-05-14;Valladolid;Todos;Personal en formación;134;22;1;21;47186
2020-05-14;Valladolid;Todos;Técnicos sanitarios;91;9;0;9;47186
2020-05-14;Zamora;Todos;Otros;0;0;0;0;49275
2020-05-15;Ávila;Todos;Auxiliares sanitarios;227;41;30;11;5019
2020-05-15;Ávila;Todos;Celador;110;9;6;3;5019
2020-05-15;Ávila;Todos;Otros;2;1;0;1;5019
2020-05-15;Ávila;Todos;Servicios de apoyo no sanitario;29;8;6;2;5019
2020-05-15;Burgos;Todos;Enfermero/a;669;81;8;73;9059
2020-05-15;Burgos;Todos;Médicos;380;56;6;50;9059
2020-05-15;Burgos;Todos;Personal en formación;51;5;0;5;9059
2020-05-15;León;Todos;Fisioterapeuta;21;2;0;2;24089
2020-05-15;León;Todos;Otros;6;0;0;0;24089
2020-05-15;León;Todos;Personal en formación;127;15;2;13;24089
2020-05-15;Palencia;Todos;Celador;36;13;3;10;34120
2020-05-15;Palencia;Todos;Enfermero/a;152;41;4;37;34120
2020-05-15;Palencia;Todos;Fisioterapeuta;4;2;1;1;34120
2020-05-15;Palencia;Todos;Otros sanitarios;6;1;0;1;34120
2020-05-15;Salamanca;Todos;Administrativo;69;20;6;14;37274
2020-05-15;Salamanca;Todos;Celador;93;23;4;19;37274
2020-05-15;Segovia;Todos;Auxiliares sanitarios;168;49;1;48;40004
2020-05-15;Segovia;Todos;Médicos;242;75;8;67;40004
2020-05-15;Segovia;Todos;Otros sanitarios;6;1;1;0;40004
2020-05-15;Soria;Todos;Administrativo;44;14;6;8;42173
2020-05-15;Soria;Todos;Celador;25;9;0;9;42173
2020-05-15;Soria;Todos;Personal en formación;9;2;1;1;42173
2020-05-15;Soria;Todos;Técnicos sanitarios;14;8;0;8;42173
2020-05-15;Valladolid;Todos;Administrativo;154;22;3;19;47186
2020-05-15;Valladolid;Todos;Médicos;618;100;7;93;47186
2020-05-15;Valladolid;Todos;Otros sanitarios;18;4;0;4;47186
2020-05-15;Valladolid;Todos;Servicios de apoyo no sanitario;79;8;1;7;47186
2020-05-15;Valladolid;Todos;Técnicos sanitarios;91;9;0;9;47186
2020-05-15;Zamora;Todos;Fisioterapeuta;2;0;0;0;49275
2020-05-15;Zamora;Todos;Otros;0;0;0;0;49275
2020-05-15;Zamora;Todos;Personal en formación;7;0;0;0;49275
2020-05-15;Zamora;Todos;Servicios de apoyo no sanitario;3;0;0;0;49275
2020-05-16;Ávila;Todos;Auxiliares sanitarios;227;41;29;12;5019
2020-05-16;Ávila;Todos;Enfermero/a;394;83;58;25;5019
2020-05-16;Ávila;Todos;Personal en formación;28;4;3;1;5019
2020-05-16;Burgos;Todos;Administrativo;78;9;1;8;9059
2020-05-16;Burgos;Todos;Auxiliares sanitarios;428;52;13;39;9059
2020-05-16;Burgos;Todos;Fisioterapeuta;17;2;1;1;9059
2020-05-16;Burgos;Todos;Médicos;382;56;6;50;9059
2020-05-16;Burgos;Todos;Otros;3;1;1;0;9059
2020-05-16;Burgos;Todos;Otros sanitarios;17;0;0;0;9059
2020-05-16;León;Todos;Enfermero/a;936;122;17;105;24089
2020-05-16;León;Todos;Servicios de apoyo no sanitario;83;4;2;2;24089
2020-05-16;Palencia;Todos;Administrativo;21;4;1;3;34120
2020-05-16;Palencia;Todos;Personal en formación;24;8;2;6;34120
2020-05-16;Salamanca;Todos;Celador;93;23;4;19;37274
2020-05-16;Salamanca;Todos;Médicos;380;120;17;103;37274
2020-05-16;Segovia;Todos;Celador;82;21;1;20;40004
2020-05-16;Segovia;Todos;Médicos;242;75;8;67;40004
2020-05-16;Segovia;Todos;Personal en formación;41;13;1;12;40004
2020-05-16;Segovia;Todos;Servicios de apoyo no sanitario;29;10;1;9;40004
2020-05-16;Segovia;Todos;Técnicos sanitarios;33;13;0;13;40004
2020-05-16;Soria;Todos;Administrativo;44;14;5;9;42173
2020-05-16;Soria;Todos;Auxiliares sanitarios;87;26;6;20;42173
2020-05-16;Soria;Todos;Enfermero/a;164;64;10;54;42173
2020-05-16;Soria;Todos;Otros sanitarios;5;2;0;2;42173
2020-05-16;Valladolid;Todos;Celador;112;22;6;16;47186
2020-05-16;Valladolid;Todos;Médicos;620;100;7;93;47186
2020-05-16;Valladolid;Todos;Personal en formación;134;22;1;21;47186
2020-05-16;Valladolid;Todos;Servicios de apoyo no sanitario;79;8;1;7;47186
2020-05-16;Valladolid;Todos;Técnicos sanitarios;91;9;0;9;47186
2020-05-16;Zamora;Todos;Auxiliares sanitarios;49;5;1;4;49275
2020-05-16;Zamora;Todos;Otros sanitarios;4;1;0;1;49275
2020-05-16;Zamora;Todos;Personal en formación;7;0;0;0;49275
2020-05-17;Ávila;Todos;Celador;110;9;6;3;5019
2020-05-17;Ávila;Todos;Médicos;251;67;31;36;5019
2020-05-17;Ávila;Todos;Otros sanitarios;10;5;3;2;5019
2020-05-17;Ávila;Todos;Personal en formación;28;4;3;1;5019
2020-05-17;Burgos;Todos;Administrativo;78;9;1;8;9059
2020-05-17;Burgos;Todos;Otros sanitarios;17;0;0;0;9059
2020-05-17;Burgos;Todos;Técnicos sanitarios;79;5;0;5;9059
2020-05-17;León;Todos;Auxiliares sanitarios;519;56;8;48;24089
2020-05-17;León;Todos;Enfermero/a;936;122;17;105;24089
2020-05-17;León;Todos;Fisioterapeuta;21;2;0;2;24089
2020-05-17;Palencia;Todos;Celador;37;13;3;10;34120
2020-05-17;Palencia;Todos;Fisioterapeuta;4;2;1;1;34120
2020-05-17;Palencia;Todos;Otros;3;1;1;0;34120
2020-05-17;Palencia;Todos;Personal en formación;24;8;2;6;34120
2020-05-17;Salamanca;Todos;Personal en formación;92;24;7;17;37274
2020-05-17;Segovia;Todos;Auxiliares sanitarios;169;49;1;48;40004
2020-05-17;Segovia;Todos;Técnicos sanitarios;33;13;0;13;40004
2020-05-17;Soria;Todos;Administrativo;44;14;5;9;42173
2020-05-17;Soria;Todos;Servicios de apoyo no sanitario;15;2;0;2;42173
2020-05-17;Valladolid;Todos;Administrativo;154;22;3;19;47186
2020-05-17;Valladolid;Todos;Auxiliares sanitarios;409;66;11;55;47186
2020-05-17;Valladolid;Todos;Otros sanitarios;18;4;0;4;47186
2020-05-17;Zamora;Todos;Enfermero/a;109;21;2;19;49275
2020-05-17;Zamora;Todos;Fisioterapeuta;2;0;0;0;49275
2020-05-17;Zamora;Todos;Personal en formación;7;0;0;0;49275
2020-05-18;Ávila;Todos;Administrativo;35;15;13;2;5019
2020-05-18;Ávila;Todos;Auxiliares sanitarios;226;42;28;14;5019
2020-05-18;Ávila;Todos;Enfermero/a;392;85;60;25;5019
2020-05-18;Ávila;Todos;Fisioterapeuta;8;0;0;0;5019
2020-05-18;Ávila;Todos;Otros sanitarios;10;5;3;2;5019
2020-05-18;Burgos;Todos;Administrativo;80;9;1;8;9059
2020-05-18;Burgos;Todos;Fisioterapeuta;18;2;1;1;9059
2020-05-18;Burgos;Todos;Otros sanitarios;17;0;0;0;9059
2020-05-18;Burgos;Todos;Servicios de apoyo no sanitario;35;3;2;1;9059
2020-05-18;León;Todos;Enfermero/a;968;123;18;105;24089
2020-05-18;León;Todos;Personal en formación;130;15;2;13;24089
2020-05-18;León;Todos;Servicios de apoyo no sanitario;84;4;2;2;24089
2020-05-18;León;Todos;Técnicos sanitarios;94;7;2;5;24089
2020-05-18;Palencia;Todos;Auxiliares sanitarios;96;19;2;17;34120
2020-05-18;Palencia;Todos;Médicos;136;30;3;27;34120
2020-05-18;Palencia;Todos;Personal en formación;24;8;2;6;34120
2020-05-18;Palencia;Todos;Servicios de apoyo no sanitario;13;3;0;3;34120
2020-05-18;Salamanca;Todos;Otros;6;2;1;1;37274
2020-05-18;Segovia;Todos;Administrativo;69;16;0;16;40004
2020-05-18;Segovia;Todos;Fisioterapeuta;4;1;0;1;40004
2020-05-18;Segovia;Todos;Médicos;244;75;8;67;40004
2020-05-18;Segovia;Todos;Otros sanitarios;6;1;1;0;40004
2020-05-18;Segovia;Todos;Personal en formación;41;13;1;12;40004
2020-05-18;Segovia;Todos;Técnicos sanitarios;33;13;0;13;40004
2020-05-18;Soria;Todos;Auxiliares sanitarios;90;26;5;21;42173
2020-05-18;Soria;Todos;Celador;26;9;0;9;42173
2020-05-18;Soria;Todos;Fisioterapeuta;4;1;0;1;42173
2020-05-18;Soria;Todos;Médicos;117;52;7;45;42173
2020-05-18;Soria;Todos;Otros sanitarios;5;2;0;2;42173
2020-05-18;Valladolid;Todos;Personal en formación;136;22;0;22;47186
2020-05-18;Valladolid;Todos;Servicios de apoyo no sanitario;81;8;1;7;47186
2020-05-18;Valladolid;Todos;Técnicos sanitarios;93;9;0;9;47186
2020-05-18;Zamora;Todos;Administrativo;21;1;0;1;49275
2020-05-18;Zamora;Todos;Auxiliares sanitarios;49;5;1;4;49275
2020-05-18;Zamora;Todos;Enfermero/a;114;21;2;19;49275
2020-05-18;Zamora;Todos;Otros sanitarios;4;1;0;1;49275
2020-05-19;Ávila;Todos;Administrativo;35;15;13;2;5019
2020-05-19;Ávila;Todos;Auxiliares sanitarios;226;42;28;14;5019
2020-05-19;Ávila;Todos;Celador;110;10;7;3;5019
2020-05-19;Ávila;Todos;Personal en formación;28;4;3;1;5019
2020-05-19;Ávila;Todos;Servicios de apoyo no sanitario;29;8;6;2;5019
2020-05-19;Ávila;Todos;Técnicos sanitarios;32;5;4;1;5019
2020-05-19;Burgos;Todos;Administrativo;82;9;1;8;9059
2020-05-19;Burgos;Todos;Celador;109;14;1;13;9059
2020-05-19;Burgos;Todos;Médicos;413;57;7;50;9059
2020-05-19;Burgos;Todos;Otros;3;1;1;0;9059
2020-05-19;Burgos;Todos;Otros sanitarios;18;0;0;0;9059
2020-05-19;León;Todos;Enfermero/a;1006;124;17;107;24089
2020-05-19;León;Todos;Otros sanitarios;20;3;0;3;24089
2020-05-19;Palencia;Todos;Fisioterapeuta;4;2;0;2;34120
2020-05-19;Palencia;Todos;Otros;4;1;1;0;34120
2020-05-19;Palencia;Todos;Personal en formación;24;8;2;6;34120
2020-05-19;Palencia;Todos;Servicios de apoyo no sanitario;13;3;0;3;34120
2020-05-19;Palencia;Todos;Técnicos sanitarios;13;3;0;3;34120
2020-05-19;Salamanca;Todos;Auxiliares sanitarios;275;81;11;70;37274
2020-05-19;Salamanca;Todos;Otros sanitarios;9;4;3;1;37274
2020-05-19;Salamanca;Todos;Personal en formación;92;24;7;17;37274
2020-05-19;Salamanca;Todos;Técnicos sanitarios;45;16;1;15;37274
2020-05-19;Segovia;Todos;Administrativo;69;16;0;16;40004
2020-05-19;Segovia;Todos;Médicos;244;75;8;67;40004
2020-05-19;Segovia;Todos;Otros;0;0;0;0;40004
2020-05-19;Segovia;Todos;Otros sanitarios;6;1;1;0;40004
2020-05-19;Soria;Todos;Administrativo;44;14;5;9;42173
2020-05-19;Soria;Todos;Celador;26;9;0;9;42173
2020-05-19;Soria;Todos;Otros;0;0;0;0;42173
2020-05-19;Soria;Todos;Otros sanitarios;5;2;0;2;42173
2020-05-19;Soria;Todos;Técnicos sanitarios;14;8;0;8;42173
2020-05-19;Valladolid;Todos;Médicos;627;100;5;95;47186
2020-05-19;Valladolid;Todos;Servicios de apoyo no sanitario;82;8;1;7;47186
2020-05-19;Zamora;Todos;Administrativo;22;1;0;1;49275
2020-05-19;Zamora;Todos;Auxiliares sanitarios;50;5;1;4;49275
2020-05-19;Zamora;Todos;Fisioterapeuta;4;0;0;0;49275
2020-05-19;Zamora;Todos;Otros sanitarios;4;1;0;1;49275
2020-05-19;Zamora;Todos;Servicios de apoyo no sanitario;5;0;0;0;49275
2020-05-19;Zamora;Todos;Técnicos sanitarios;12;0;0;0;49275
2020-05-20;Burgos;Todos;Médicos;416;57;7;50;9059
2020-05-20;Burgos;Todos;Otros sanitarios;18;0;0;0;9059
2020-05-20;Burgos;Todos;Personal en formación;62;5;0;5;9059
2020-05-20;León;Todos;Auxiliares sanitarios;579;56;6;50;24089
2020-05-20;León;Todos;Enfermero/a;1026;124;14;110;24089
2020-05-20;León;Todos;Fisioterapeuta;28;2;0;2;24089
2020-05-20;León;Todos;Otros;6;0;0;0;24089
2020-05-20;León;Todos;Técnicos sanitarios;181;7;2;5;24089
2020-05-20;Palencia;Todos;Enfermero/a;163;41;4;37;34120
2020-05-20;Palencia;Todos;Médicos;137;30;3;27;34120
2020-05-20;Palencia;Todos;Otros sanitarios;6;1;0;1;34120
2020-05-20;Palencia;Todos;Servicios de apoyo no sanitario;13;3;0;3;34120
2020-05-20;Palencia;Todos;Técnicos sanitarios;13;3;0;3;34120
2020-05-20;Salamanca;Todos;Auxiliares sanitarios;280;81;10;71;37274
2020-05-20;Salamanca;Todos;Celador;97;23;2;21;37274
2020-05-20;Salamanca;Todos;Fisioterapeuta;12;5;1;4;37274
2020-05-20;Salamanca;Todos;Otros;6;2;1;1;37274
2020-05-20;Salamanca;Todos;Personal en formación;94;24;6;18;37274
2020-05-20;Segovia;Todos;Administrativo;69;16;0;16;40004
2020-05-20;Segovia;Todos;Celador;84;21;1;20;40004
2020-05-20;Segovia;Todos;Servicios de apoyo no sanitario;29;10;1;9;40004
2020-05-20;Segovia;Todos;Técnicos sanitarios;34;13;0;13;40004
2020-05-20;Soria;Todos;Auxiliares sanitarios;92;26;5;21;42173
2020-05-20;Soria;Todos;Celador;26;9;0;9;42173
2020-05-20;Soria;Todos;Otros;0;0;0;0;42173
2020-05-20;Soria;Todos;Otros sanitarios;5;2;0;2;42173
2020-05-20;Soria;Todos;Servicios de apoyo no sanitario;15;2;0;2;42173
2020-05-20;Soria;Todos;Técnicos sanitarios;14;8;0;8;42173
2020-05-20;Valladolid;Todos;Auxiliares sanitarios;447;68;4;64;47186
2020-05-20;Zamora;Todos;Otros;0;0;0;0;49275
2020-05-20;Zamora;Todos;Otros sanitarios;4;1;1;0;49275
2020-05-20;Zamora;Todos;Personal en formación;8;0;0;0;49275
2020-05-20;Zamora;Todos;Servicios de apoyo no sanitario;5;0;0;0;49275
2020-05-21;Ávila;Todos;Auxiliares sanitarios;227;42;27;15;5019
2020-05-21;Ávila;Todos;Personal en formación;28;4;3;1;5019
2020-05-21;Ávila;Todos;Técnicos sanitarios;32;5;3;2;5019
2020-05-21;Burgos;Todos;Administrativo;86;9;1;8;9059
2020-05-21;Burgos;Todos;Celador;122;15;2;13;9059
2020-05-21;Burgos;Todos;Enfermero/a;823;82;8;74;9059
2020-05-21;Burgos;Todos;Otros;3;1;1;0;9059
2020-05-21;Burgos;Todos;Personal en formación;74;5;0;5;9059
2020-05-21;Burgos;Todos;Técnicos sanitarios;88;5;0;5;9059
2020-05-21;León;Todos;Administrativo;162;8;1;7;24089
2020-05-21;León;Todos;Auxiliares sanitarios;611;57;4;53;24089
2020-05-21;León;Todos;Celador;245;17;2;15;24089
2020-05-21;León;Todos;Enfermero/a;1063;124;12;112;24089
2020-05-21;Palencia;Todos;Auxiliares sanitarios;98;21;4;17;34120
2020-05-21;Palencia;Todos;Otros sanitarios;6;1;0;1;34120
2020-05-21;Palencia;Todos;Servicios de apoyo no sanitario;13;3;0;3;34120
2020-05-21;Salamanca;Todos;Enfermero/a;477;119;22;97;37274
2020-05-21;Salamanca;Todos;Otros;6;2;0;2;37274
2020-05-21;Salamanca;Todos;Técnicos sanitarios;48;16;1;15;37274
2020-05-21;Segovia;Todos;Auxiliares sanitarios;173;49;1;48;40004
2020-05-21;Segovia;Todos;Celador;84;21;1;20;40004
2020-05-21;Segovia;Todos;Enfermero/a;342;122;2;120;40004
2020-05-21;Segovia;Todos;Personal en formación;41;13;1;12;40004
2020-05-21;Segovia;Todos;Servicios de apoyo no sanitario;29;10;1;9;40004
2020-05-21;Segovia;Todos;Técnicos sanitarios;34;13;0;13;40004
2020-05-21;Soria;Todos;Celador;26;9;0;9;42173
2020-05-21;Soria;Todos;Fisioterapeuta;4;1;0;1;42173
2020-05-21;Soria;Todos;Técnicos sanitarios;14;8;0;8;42173
2020-05-21;Valladolid;Todos;Administrativo;159;22;2;20;47186
2020-05-21;Valladolid;Todos;Auxiliares sanitarios;448;68;5;63;47186
2020-05-21;Valladolid;Todos;Otros sanitarios;19;4;0;4;47186
2020-05-21;Valladolid;Todos;Servicios de apoyo no sanitario;83;8;1;7;47186
2020-05-21;Valladolid;Todos;Técnicos sanitarios;95;9;0;9;47186
2020-05-21;Zamora;Todos;Administrativo;23;1;0;1;49275
2020-05-21;Zamora;Todos;Celador;31;3;0;3;49275
2020-05-21;Zamora;Todos;Enfermero/a;118;21;2;19;49275
2020-05-21;Zamora;Todos;Médicos;125;20;2;18;49275
2020-05-21;Zamora;Todos;Otros;0;0;0;0;49275
2020-05-21;Zamora;Todos;Otros sanitarios;4;1;1;0;49275
2020-05-22;Ávila;Todos;Administrativo;35;15;13;2;5019
2020-05-22;Ávila;Todos;Celador;110;10;7;3;5019
2020-05-22;Ávila;Todos;Fisioterapeuta;8;0;0;0;5019
2020-05-22;Ávila;Todos;Médicos;255;67;30;37;5019
2020-05-22;Ávila;Todos;Personal en formación;28;4;3;1;5019
2020-05-22;Ávila;Todos;Servicios de apoyo no sanitario;29;8;6;2;5019
2020-05-22;Burgos;Todos;Auxiliares sanitarios;515;52;11;41;9059
2020-05-22;Burgos;Todos;Celador;124;15;2;13;9059
2020-05-22;Burgos;Todos;Otros;3;1;1;0;9059
2020-05-22;León;Todos;Administrativo;166;9;2;7;24089
2020-05-22;León;Todos;Auxiliares sanitarios;637;58;4;54;24089
2020-05-22;León;Todos;Otros sanitarios;20;3;0;3;24089
2020-05-22;Palencia;Todos;Administrativo;21;4;1;3;34120
2020-05-22;Palencia;Todos;Auxiliares sanitarios;98;21;5;16;34120
2020-05-22;Palencia;Todos;Celador;38;12;1;11;34120
2020-05-22;Palencia;Todos;Personal en formación;25;8;2;6;34120
2020-05-22;Palencia;Todos;Servicios de apoyo no sanitario;13;3;0;3;34120
2020-05-22;Salamanca;Todos;Administrativo;83;20;5;15;37274
2020-05-22;Salamanca;Todos;Auxiliares sanitarios;287;81;8;73;37274
2020-05-22;Salamanca;Todos;Técnicos sanitarios;49;16;1;15;37274
2020-05-22;Segovia;Todos;Administrativo;69;16;0;16;40004
2020-05-22;Segovia;Todos;Enfermero/a;342;122;2;120;40004
2020-05-22;Segovia;Todos;Fisioterapeuta;4;1;0;1;40004
2020-05-22;Segovia;Todos;Otros;0;0;0;0;40004
2020-05-22;Segovia;Todos;Otros sanitarios;6;1;1;0;40004
2020-05-22;Segovia;Todos;Personal en formación;41;13;1;12;40004
2020-05-22;Segovia;Todos;Servicios de apoyo no sanitario;29;10;1;9;40004
2020-05-22;Segovia;Todos;Técnicos sanitarios;34;13;0;13;40004
2020-05-22;Soria;Todos;Celador;26;9;0;9;42173
2020-05-22;Valladolid;Todos;Administrativo;160;22;1;21;47186
2020-05-22;Valladolid;Todos;Médicos;641;100;2;98;47186
2020-05-22;Valladolid;Todos;Otros sanitarios;19;4;0;4;47186
2020-05-22;Valladolid;Todos;Servicios de apoyo no sanitario;83;8;1;7;47186
2020-05-22;Zamora;Todos;Administrativo;23;1;0;1;49275
2020-05-22;Zamora;Todos;Celador;31;3;0;3;49275
2020-05-22;Zamora;Todos;Personal en formación;8;0;0;0;49275
2020-05-22;Zamora;Todos;Técnicos sanitarios;12;0;0;0;49275
2020-05-23;Ávila;Todos;Auxiliares sanitarios;228;42;25;17;5019
2020-05-23;Ávila;Todos;Fisioterapeuta;8;0;0;0;5019
2020-05-23;Ávila;Todos;Otros sanitarios;10;5;3;2;5019
2020-05-23;Ávila;Todos;Técnicos sanitarios;32;5;3;2;5019
2020-05-23;Burgos;Todos;Administrativo;97;9;1;8;9059
2020-05-23;Burgos;Todos;Fisioterapeuta;18;2;0;2;9059
2020-05-23;Burgos;Todos;Médicos;439;57;7;50;9059
2020-05-23;Burgos;Todos;Personal en formación;74;5;0;5;9059
2020-05-23;Burgos;Todos;Técnicos sanitarios;89;5;0;5;9059
2020-05-23;León;Todos;Otros sanitarios;20;3;0;3;24089
2020-05-23;León;Todos;Servicios de apoyo no sanitario;88;4;0;4;24089
2020-05-23;Palencia;Todos;Administrativo;21;4;1;3;34120
2020-05-23;Palencia;Todos;Médicos;137;30;3;27;34120
2020-05-23;Palencia;Todos;Personal en formación;25;8;2;6;34120
2020-05-23;Palencia;Todos;Servicios de apoyo no sanitario;13;3;0;3;34120
2020-05-23;Salamanca;Todos;Celador;101;23;2;21;37274
2020-05-23;Salamanca;Todos;Médicos;393;120;15;105;37274
2020-05-23;Segovia;Todos;Administrativo;69;16;0;16;40004
2020-05-23;Segovia;Todos;Técnicos sanitarios;34;13;0;13;40004
2020-05-23;Soria;Todos;Administrativo;44;14;5;9;42173
2020-05-23;Soria;Todos;Fisioterapeuta;4;1;0;1;42173
2020-05-23;Soria;Todos;Técnicos sanitarios;14;8;0;8;42173
2020-05-23;Valladolid;Todos;Administrativo;160;22;1;21;47186
2020-05-23;Valladolid;Todos;Enfermero/a;949;149;11;138;47186
2020-05-23;Valladolid;Todos;Otros;5;0;0;0;47186
2020-05-23;Valladolid;Todos;Personal en formación;139;22;0;22;47186
2020-05-23;Zamora;Todos;Auxiliares sanitarios;53;5;1;4;49275
2020-05-24;Ávila;Todos;Celador;110;10;7;3;5019
2020-05-24;Ávila;Todos;Enfermero/a;397;85;58;27;5019
2020-05-24;Burgos;Todos;Celador;124;15;2;13;9059
2020-05-24;Burgos;Todos;Fisioterapeuta;18;2;0;2;9059
2020-05-24;Burgos;Todos;Otros;4;1;1;0;9059
2020-05-24;León;Todos;Administrativo;166;9;2;7;24089
2020-05-24;León;Todos;Auxiliares sanitarios;637;58;4;54;24089
2020-05-24;León;Todos;Fisioterapeuta;33;2;0;2;24089
2020-05-24;León;Todos;Médicos;687;80;2;78;24089
2020-05-24;León;Todos;Personal en formación;144;15;0;15;24089
2020-05-24;Palencia;Todos;Administrativo;21;4;1;3;34120
2020-05-24;Palencia;Todos;Otros sanitarios;6;1;0;1;34120
2020-05-24;Palencia;Todos;Servicios de apoyo no sanitario;13;3;0;3;34120
2020-05-24;Salamanca;Todos;Otros;6;2;0;2;37274
2020-05-24;Salamanca;Todos;Otros sanitarios;10;4;3;1;37274
2020-05-24;Salamanca;Todos;Servicios de apoyo no sanitario;57;12;1;11;37274
2020-05-24;Salamanca;Todos;Técnicos sanitarios;49;16;1;15;37274
2020-05-24;Segovia;Todos;Celador;84;21;1;20;40004
2020-05-24;Segovia;Todos;Personal en formación;41;13;1;12;40004
2020-05-24;Soria;Todos;Administrativo;44;14;5;9;42173
2020-05-24;Soria;Todos;Celador;27;9;0;9;42173
2020-05-24;Soria;Todos;Enfermero/a;169;64;10;54;42173
2020-05-24;Soria;Todos;Otros sanitarios;5;2;0;2;42173
2020-05-24;Soria;Todos;Personal en formación;10;2;1;1;42173
2020-05-24;Valladolid;Todos;Celador;132;23;6;17;47186
2020-05-24;Valladolid;Todos;Enfermero/a;949;149;11;138;47186
2020-05-24;Valladolid;Todos;Otros sanitarios;19;4;0;4;47186
2020-05-24;Valladolid;Todos;Personal en formación;141;22;0;22;47186
2020-05-24;Zamora;Todos;Administrativo;23;1;0;1;49275
2020-05-24;Zamora;Todos;Celador;31;3;0;3;49275
2020-05-24;Zamora;Todos;Otros;0;0;0;0;49275
2020-05-24;Zamora;Todos;Personal en formación;8;0;0;0;49275
2020-05-24;Zamora;Todos;Servicios de apoyo no sanitario;5;0;0;0;49275
2020-05-24;Zamora;Todos;Técnicos sanitarios;12;0;0;0;49275
2020-05-25;Ávila;Todos;Administrativo;35;15;13;2;5019
2020-05-25;Ávila;Todos;Celador;110;10;7;3;5019
2020-05-25;Ávila;Todos;Enfermero/a;399;85;56;29;5019
2020-05-25;Ávila;Todos;Fisioterapeuta;8;0;0;0;5019
2020-05-25;Ávila;Todos;Personal en formación;28;4;3;1;5019
2020-05-25;Ávila;Todos;Técnicos sanitarios;33;5;3;2;5019
2020-05-25;Burgos;Todos;Técnicos sanitarios;89;5;0;5;9059
2020-05-25;León;Todos;Celador;273;17;2;15;24089
2020-05-25;León;Todos;Servicios de apoyo no sanitario;88;4;0;4;24089
2020-05-25;Palencia;Todos;Enfermero/a;168;42;4;38;34120
2020-05-25;Palencia;Todos;Servicios de apoyo no sanitario;14;3;0;3;34120
2020-05-25;Salamanca;Todos;Enfermero/a;498;120;22;98;37274
2020-05-25;Salamanca;Todos;Servicios de apoyo no sanitario;58;12;1;11;37274
2020-05-25;Segovia;Todos;Celador;84;21;1;20;40004
2020-05-25;Segovia;Todos;Médicos;249;75;8;67;40004
2020-05-25;Segovia;Todos;Servicios de apoyo no sanitario;29;10;1;9;40004
2020-05-25;Segovia;Todos;Técnicos sanitarios;34;13;0;13;40004
2020-05-25;Soria;Todos;Administrativo;45;14;5;9;42173
2020-05-25;Soria;Todos;Auxiliares sanitarios;92;26;3;23;42173
2020-05-25;Soria;Todos;Médicos;117;52;6;46;42173
2020-05-25;Soria;Todos;Otros sanitarios;5;2;0;2;42173
2020-05-25;Soria;Todos;Técnicos sanitarios;14;8;0;8;42173
2020-05-25;Valladolid;Todos;Fisioterapeuta;24;3;0;3;47186
2020-05-25;Valladolid;Todos;Médicos;647;100;2;98;47186
2020-05-25;Zamora;Todos;Auxiliares sanitarios;53;5;1;4;49275
2020-05-25;Zamora;Todos;Otros;0;0;0;0;49275
2020-05-25;Zamora;Todos;Personal en formación;8;0;0;0;49275
2020-05-25;Zamora;Todos;Técnicos sanitarios;12;0;0;0;49275
2020-05-26;Ávila;Todos;Fisioterapeuta;8;0;0;0;5019
2020-05-26;Ávila;Todos;Otros sanitarios;10;5;3;2;5019
2020-05-26;Burgos;Todos;Celador;139;15;1;14;9059
2020-05-26;Burgos;Todos;Enfermero/a;918;82;5;77;9059
2020-05-26;Burgos;Todos;Fisioterapeuta;18;2;0;2;9059
2020-05-26;Burgos;Todos;Médicos;468;57;6;51;9059
2020-05-26;Burgos;Todos;Otros;4;1;1;0;9059
2020-05-26;Burgos;Todos;Servicios de apoyo no sanitario;48;4;1;3;9059
2020-05-26;Burgos;Todos;Técnicos sanitarios;89;5;0;5;9059
2020-05-26;León;Todos;Administrativo;175;9;1;8;24089
2020-05-26;León;Todos;Enfermero/a;1206;125;10;115;24089
2020-05-26;León;Todos;Otros;6;0;0;0;24089
2020-05-26;Palencia;Todos;Celador;40;13;1;12;34120
2020-05-26;Palencia;Todos;Fisioterapeuta;5;2;0;2;34120
2020-05-26;Palencia;Todos;Personal en formación;26;8;1;7;34120
2020-05-26;Salamanca;Todos;Auxiliares sanitarios;299;81;9;72;37274
2020-05-26;Salamanca;Todos;Otros sanitarios;10;4;2;2;37274
2020-05-26;Segovia;Todos;Administrativo;71;16;0;16;40004
2020-05-26;Segovia;Todos;Enfermero/a;346;122;2;120;40004
2020-05-26;Segovia;Todos;Otros sanitarios;6;1;1;0;40004
2020-05-26;Segovia;Todos;Personal en formación;41;13;1;12;40004
2020-05-26;Soria;Todos;Fisioterapeuta;4;1;0;1;42173
2020-05-26;Soria;Todos;Médicos;117;52;5;47;42173
2020-05-26;Soria;Todos;Otros;0;0;0;0;42173
2020-05-26;Soria;Todos;Servicios de apoyo no sanitario;16;2;0;2;42173
2020-05-26;Valladolid;Todos;Administrativo;164;22;1;21;47186
2020-05-26;Valladolid;Todos;Otros sanitarios;20;4;0;4;47186
2020-05-26;Valladolid;Todos;Personal en formación;141;22;0;22;47186
2020-05-26;Valladolid;Todos;Técnicos sanitarios;101;9;0;9;47186
2020-05-26;Zamora;Todos;Celador;31;3;0;3;49275
2020-05-26;Zamora;Todos;Médicos;128;20;2;18;49275
2020-05-26;Zamora;Todos;Personal en formación;8;0;0;0;49275
2020-05-26;Zamora;Todos;Técnicos sanitarios;12;0;0;0;49275
2020-05-27;Ávila;Todos;Auxiliares sanitarios;228;42;25;17;5019
2020-05-27;Ávila;Todos;Médicos;255;67;30;37;5019
2020-05-27;Ávila;Todos;Otros sanitarios;10;5;3;2;5019
2020-05-27;Ávila;Todos;Personal en formación;28;4;3;1;5019
2020-05-27;Burgos;Todos;Celador;140;15;1;14;9059
2020-05-27;Burgos;Todos;Personal en formación;78;5;0;5;9059
2020-05-27;León;Todos;Administrativo;178;9;1;8;24089
2020-05-27;León;Todos;Enfermero/a;1235;125;9;116;24089
2020-05-27;León;Todos;Médicos;709;81;3;78;24089
2020-05-27;León;Todos;Servicios de apoyo no sanitario;88;4;0;4;24089
2020-05-27;Palencia;Todos;Celador;40;13;1;12;34120
2020-05-27;Palencia;Todos;Fisioterapeuta;5;2;0;2;34120
2020-05-27;Palencia;Todos;Médicos;140;30;2;28;34120
2020-05-27;Palencia;Todos;Personal en formación;26;8;1;7;34120
2020-05-27;Salamanca;Todos;Auxiliares sanitarios;300;81;9;72;37274
2020-05-27;Salamanca;Todos;Celador;103;23;2;21;37274
2020-05-27;Salamanca;Todos;Médicos;400;120;14;106;37274
2020-05-27;Segovia;Todos;Auxiliares sanitarios;175;49;0;49;40004
2020-05-27;Segovia;Todos;Otros;0;0;0;0;40004
2020-05-27;Soria;Todos;Celador;27;9;0;9;42173
2020-05-27;Soria;Todos;Médicos;118;52;4;48;42173
2020-05-27;Valladolid;Todos;Auxiliares sanitarios;464;68;4;64;47186
2020-05-27;Valladolid;Todos;Enfermero/a;960;151;10;141;47186
2020-05-27;Valladolid;Todos;Fisioterapeuta;24;3;0;3;47186
2020-05-27;Valladolid;Todos;Servicios de apoyo no sanitario;85;8;1;7;47186
2020-05-27;Valladolid;Todos;Técnicos sanitarios;101;9;0;9;47186
2020-05-27;Zamora;Todos;Fisioterapeuta;4;0;0;0;49275
2020-05-27;Zamora;Todos;Médicos;128;20;2;18;49275
2020-05-28;Ávila;Todos;Auxiliares sanitarios;228;42;25;17;5019
2020-05-28;Ávila;Todos;Fisioterapeuta;8;0;0;0;5019
2020-05-28;Ávila;Todos;Servicios de apoyo no sanitario;29;8;6;2;5019
2020-05-28;Ávila;Todos;Técnicos sanitarios;34;5;3;2;5019
2020-05-28;Burgos;Todos;Administrativo;107;9;0;9;9059
2020-05-28;Burgos;Todos;Auxiliares sanitarios;584;52;9;43;9059
2020-05-28;Burgos;Todos;Médicos;493;57;6;51;9059
2020-05-28;Burgos;Todos;Personal en formación;78;5;0;5;9059
2020-05-28;León;Todos;Enfermero/a;1295;125;10;115;24089
2020-05-28;León;Todos;Personal en formación;154;15;0;15;24089
2020-05-28;Palencia;Todos;Administrativo;21;4;1;3;34120
2020-05-28;Palencia;Todos;Celador;40;13;0;13;34120
2020-05-28;Palencia;Todos;Otros;4;1;1;0;34120
2020-05-28;Palencia;Todos;Otros sanitarios;6;1;0;1;34120
2020-05-28;Palencia;Todos;Personal en formación;26;8;0;8;34120
2020-05-28;Salamanca;Todos;Administrativo;86;20;5;15;37274
2020-05-28;Salamanca;Todos;Celador;103;23;2;21;37274
2020-05-28;Salamanca;Todos;Otros sanitarios;10;4;2;2;37274
2020-05-28;Segovia;Todos;Auxiliares sanitarios;175;49;0;49;40004
2020-05-28;Segovia;Todos;Celador;85;21;1;20;40004
2020-05-28;Segovia;Todos;Enfermero/a;346;122;2;120;40004
2020-05-28;Segovia;Todos;Otros;0;0;0;0;40004
2020-05-28;Soria;Todos;Administrativo;46;14;3;11;42173
2020-05-28;Soria;Todos;Auxiliares sanitarios;93;26;2;24;42173
2020-05-28;Soria;Todos;Celador;27;9;0;9;42173
2020-05-28;Soria;Todos;Enfermero/a;169;64;10;54;42173
2020-05-28;Soria;Todos;Fisioterapeuta;4;1;0;1;42173
2020-05-28;Valladolid;Todos;Auxiliares sanitarios;467;68;3;65;47186
2020-05-28;Valladolid;Todos;Celador;134;23;3;20;47186
2020-05-28;Valladolid;Todos;Médicos;653;100;1;99;47186
2020-05-28;Valladolid;Todos;Otros sanitarios;21;5;1;4;47186
2020-05-28;Valladolid;Todos;Técnicos sanitarios;101;9;0;9;47186
2020-05-28;Zamora;Todos;Fisioterapeuta;4;0;0;0;49275
2020-05-29;Ávila;Todos;Celador;111;10;7;3;5019
2020-05-29;Ávila;Todos;Personal en formación;28;4;3;1;5019
2020-05-29;Ávila;Todos;Servicios de apoyo no sanitario;29;8;6;2;5019
2020-05-29;Ávila;Todos;Técnicos sanitarios;34;5;3;2;5019
2020-05-29;Burgos;Todos;Administrativo;108;9;0;9;9059
2020-05-29;Burgos;Todos;Médicos;516;57;7;50;9059
2020-05-29;Burgos;Todos;Personal en formación;85;5;0;5;9059
2020-05-29;Burgos;Todos;Servicios de apoyo no sanitario;48;4;0;4;9059
2020-05-29;León;Todos;Otros sanitarios;21;3;0;3;24089
2020-05-29;Palencia;Todos;Médicos;141;30;0;30;34120
2020-05-29;Palencia;Todos;Otros;4;1;1;0;34120
2020-05-29;Salamanca;Todos;Administrativo;86;20;5;15;37274
2020-05-29;Salamanca;Todos;Auxiliares sanitarios;306;81;8;73;37274
2020-05-29;Salamanca;Todos;Celador;103;23;2;21;37274
2020-05-29;Salamanca;Todos;Médicos;407;120;14;106;37274
2020-05-29;Segovia;Todos;Celador;85;21;1;20;40004
2020-05-29;Segovia;Todos;Personal en formación;41;13;1;12;40004
2020-05-29;Segovia;Todos;Técnicos sanitarios;34;13;0;13;40004
2020-05-29;Soria;Todos;Administrativo;46;14;3;11;42173
2020-05-29;Soria;Todos;Enfermero/a;169;64;10;54;42173
2020-05-29;Soria;Todos;Médicos;122;53;5;48;42173
2020-05-29;Soria;Todos;Técnicos sanitarios;15;8;0;8;42173
2020-05-29;Valladolid;Todos;Administrativo;168;22;1;21;47186
2020-05-29;Valladolid;Todos;Enfermero/a;972;152;9;143;47186
2020-05-29;Valladolid;Todos;Médicos;660;100;1;99;47186
2020-05-29;Valladolid;Todos;Otros sanitarios;21;5;1;4;47186
2020-05-29;Valladolid;Todos;Servicios de apoyo no sanitario;85;8;1;7;47186
2020-05-29;Zamora;Todos;Administrativo;23;1;0;1;49275
2020-05-29;Zamora;Todos;Auxiliares sanitarios;54;5;0;5;49275
2020-05-29;Zamora;Todos;Enfermero/a;128;21;2;19;49275
2020-05-29;Zamora;Todos;Fisioterapeuta;4;0;0;0;49275
2020-05-30;Ávila;Todos;Auxiliares sanitarios;228;42;25;17;5019
2020-05-30;Ávila;Todos;Enfermero/a;400;85;54;31;5019
2020-05-30;Ávila;Todos;Médicos;255;67;30;37;5019
2020-05-30;Burgos;Todos;Administrativo;108;9;0;9;9059
2020-05-30;Burgos;Todos;Enfermero/a;1007;83;4;79;9059
2020-05-30;Burgos;Todos;Otros;5;1;0;1;9059
2020-05-30;León;Todos;Administrativo;179;9;1;8;24089
2020-05-30;León;Todos;Celador;296;17;2;15;24089
2020-05-30;León;Todos;Fisioterapeuta;40;2;0;2;24089
2020-05-30;León;Todos;Otros sanitarios;21;3;0;3;24089
2020-05-30;Palencia;Todos;Fisioterapeuta;5;2;0;2;34120
2020-05-30;Palencia;Todos;Médicos;141;30;0;30;34120
2020-05-30;Palencia;Todos;Servicios de apoyo no sanitario;20;3;0;3;34120
2020-05-30;Salamanca;Todos;Enfermero/a;514;121;23;98;37274
2020-05-30;Salamanca;Todos;Otros;7;2;0;2;37274
2020-05-30;Salamanca;Todos;Servicios de apoyo no sanitario;65;12;1;11;37274
2020-05-30;Segovia;Todos;Administrativo;72;16;0;16;40004
2020-05-30;Segovia;Todos;Auxiliares sanitarios;175;49;0;49;40004
2020-05-30;Soria;Todos;Fisioterapeuta;4;1;0;1;42173
2020-05-30;Soria;Todos;Médicos;122;53;5;48;42173
2020-05-30;Soria;Todos;Servicios de apoyo no sanitario;16;2;0;2;42173
2020-05-30;Valladolid;Todos;Auxiliares sanitarios;469;68;2;66;47186
2020-05-30;Valladolid;Todos;Celador;134;23;3;20;47186
2020-05-30;Valladolid;Todos;Médicos;660;100;1;99;47186
2020-05-30;Valladolid;Todos;Técnicos sanitarios;101;9;0;9;47186
2020-05-30;Zamora;Todos;Administrativo;23;1;0;1;49275
2020-05-30;Zamora;Todos;Auxiliares sanitarios;54;5;0;5;49275
2020-05-30;Zamora;Todos;Enfermero/a;128;21;2;19;49275
2020-05-30;Zamora;Todos;Médicos;130;20;2;18;49275
2020-05-30;Zamora;Todos;Servicios de apoyo no sanitario;5;0;0;0;49275
2020-05-31;Ávila;Todos;Otros;3;1;0;1;5019
2020-05-31;Ávila;Todos;Técnicos sanitarios;34;5;3;2;5019
2020-05-31;Burgos;Todos;Técnicos sanitarios;94;5;0;5;9059
2020-05-31;León;Todos;Administrativo;179;9;1;8;24089
2020-05-31;León;Todos;Auxiliares sanitarios;787;60;5;55;24089
2020-05-31;León;Todos;Fisioterapeuta;40;2;0;2;24089
2020-05-31;León;Todos;Otros;6;0;0;0;24089
2020-05-31;León;Todos;Otros sanitarios;21;3;0;3;24089
2020-05-31;León;Todos;Personal en formación;154;15;0;15;24089
2020-05-31;León;Todos;Servicios de apoyo no sanitario;88;4;0;4;24089
2020-05-31;Palencia;Todos;Otros;4;1;1;0;34120
2020-05-31;Palencia;Todos;Otros sanitarios;6;1;0;1;34120
2020-05-31;Salamanca;Todos;Administrativo;90;20;5;15;37274
2020-05-31;Salamanca;Todos;Auxiliares sanitarios;310;81;9;72;37274
2020-05-31;Salamanca;Todos;Celador;103;23;2;21;37274
2020-05-31;Salamanca;Todos;Técnicos sanitarios;50;16;1;15;37274
2020-05-31;Segovia;Todos;Auxiliares sanitarios;176;49;0;49;40004
2020-05-31;Segovia;Todos;Celador;85;21;1;20;40004
2020-05-31;Segovia;Todos;Fisioterapeuta;4;1;0;1;40004
2020-05-31;Soria;Todos;Otros;0;0;0;0;42173
2020-05-31;Soria;Todos;Personal en formación;10;2;1;1;42173
2020-05-31;Soria;Todos;Técnicos sanitarios;15;8;0;8;42173
2020-05-31;Valladolid;Todos;Celador;134;23;3;20;47186
2020-05-31;Valladolid;Todos;Enfermero/a;973;153;10;143;47186
2020-05-31;Valladolid;Todos;Fisioterapeuta;24;3;0;3;47186
2020-05-31;Valladolid;Todos;Médicos;660;100;1;99;47186
2020-05-31;Valladolid;Todos;Otros;6;0;0;0;47186
2020-05-31;Valladolid;Todos;Otros sanitarios;21;5;1;4;47186
2020-05-31;Valladolid;Todos;Servicios de apoyo no sanitario;85;8;1;7;47186
2020-05-31;Zamora;Todos;Servicios de apoyo no sanitario;5;0;0;0;49275
2020-06-01;Ávila;Todos;Enfermero/a;400;85;53;32;5019
2020-06-01;Ávila;Todos;Otros;3;1;0;1;5019
2020-06-01;Burgos;Todos;Celador;154;15;0;15;9059
2020-06-01;Burgos;Todos;Fisioterapeuta;19;2;0;2;9059
2020-06-01;Burgos;Todos;Otros;5;1;0;1;9059
2020-06-01;Burgos;Todos;Personal en formación;96;5;0;5;9059
2020-06-01;Burgos;Todos;Servicios de apoyo no sanitario;48;4;0;4;9059
2020-06-01;León;Todos;Auxiliares sanitarios;840;60;5;55;24089
2020-06-01;León;Todos;Otros sanitarios;23;3;0;3;24089
2020-06-01;Palencia;Todos;Administrativo;21;4;1;3;34120
2020-06-01;Palencia;Todos;Otros sanitarios;6;1;0;1;34120
2020-06-01;Palencia;Todos;Técnicos sanitarios;14;3;0;3;34120
2020-06-01;Salamanca;Todos;Administrativo;90;20;5;15;37274
2020-06-01;Segovia;Todos;Fisioterapeuta;4;1;0;1;40004
2020-06-01;Segovia;Todos;Otros sanitarios;6;1;1;0;40004
2020-06-01;Segovia;Todos;Técnicos sanitarios;34;13;0;13;40004
2020-06-01;Soria;Todos;Otros sanitarios;5;2;0;2;42173
2020-06-01;Valladolid;Todos;Administrativo;170;22;1;21;47186
2020-06-01;Valladolid;Todos;Auxiliares sanitarios;470;68;1;67;47186
2020-06-01;Valladolid;Todos;Celador;136;23;3;20;47186
2020-06-01;Valladolid;Todos;Enfermero/a;975;153;8;145;47186
2020-06-01;Zamora;Todos;Auxiliares sanitarios;54;5;0;5;49275
2020-06-01;Zamora;Todos;Fisioterapeuta;4;0;0;0;49275
2020-06-01;Zamora;Todos;Otros sanitarios;6;1;0;1;49275
2020-06-01;Zamora;Todos;Personal en formación;8;0;0;0;49275
2020-06-01;Zamora;Todos;Servicios de apoyo no sanitario;5;0;0;0;49275
2020-06-02;Ávila;Todos;Otros sanitarios;10;5;3;2;5019
2020-06-02;Ávila;Todos;Servicios de apoyo no sanitario;29;8;5;3;5019
2020-06-02;Ávila;Todos;Técnicos sanitarios;34;5;3;2;5019
2020-06-02;Burgos;Todos;Médicos;578;58;8;50;9059
2020-06-02;Burgos;Todos;Otros;5;1;0;1;9059
2020-06-02;Burgos;Todos;Personal en formación;107;5;0;5;9059
2020-06-02;León;Todos;Administrativo;214;9;1;8;24089
2020-06-02;León;Todos;Enfermero/a;1430;125;8;117;24089
2020-06-02;León;Todos;Fisioterapeuta;41;2;0;2;24089
2020-06-02;León;Todos;Otros sanitarios;23;3;0;3;24089
2020-06-02;Palencia;Todos;Administrativo;21;4;1;3;34120
2020-06-02;Palencia;Todos;Enfermero/a;172;42;4;38;34120
2020-06-02;Palencia;Todos;Médicos;143;30;0;30;34120
2020-06-02;Palencia;Todos;Otros;4;1;1;0;34120
2020-06-02;Palencia;Todos;Otros sanitarios;6;1;0;1;34120
2020-06-02;Palencia;Todos;Servicios de apoyo no sanitario;20;3;0;3;34120
2020-06-02;Salamanca;Todos;Administrativo;92;20;4;16;37274
2020-06-02;Salamanca;Todos;Otros sanitarios;10;4;2;2;37274
2020-06-02;Segovia;Todos;Auxiliares sanitarios;176;49;0;49;40004
2020-06-02;Segovia;Todos;Fisioterapeuta;4;1;0;1;40004
2020-06-02;Soria;Todos;Celador;27;9;0;9;42173
2020-06-02;Valladolid;Todos;Administrativo;170;22;1;21;47186
2020-06-02;Valladolid;Todos;Médicos;664;100;1;99;47186
2020-06-02;Valladolid;Todos;Técnicos sanitarios;103;9;0;9;47186
2020-06-02;Zamora;Todos;Administrativo;23;1;0;1;49275
2020-06-02;Zamora;Todos;Celador;31;3;0;3;49275
2020-06-02;Zamora;Todos;Enfermero/a;129;21;2;19;49275
2020-06-02;Zamora;Todos;Médicos;131;20;2;18;49275
2020-06-02;Zamora;Todos;Otros sanitarios;6;1;0;1;49275
2020-06-02;Zamora;Todos;Técnicos sanitarios;13;0;0;0;49275
2020-06-03;Ávila;Todos;Auxiliares sanitarios;227;42;23;19;5019
2020-06-03;Ávila;Todos;Otros sanitarios;10;5;3;2;5019
2020-06-03;Ávila;Todos;Personal en formación;28;4;3;1;5019
2020-06-03;Ávila;Todos;Servicios de apoyo no sanitario;29;8;5;3;5019
2020-06-03;Burgos;Todos;Enfermero/a;1149;83;1;82;9059
2020-06-03;Burgos;Todos;Servicios de apoyo no sanitario;50;4;0;4;9059
2020-06-03;León;Todos;Administrativo;218;9;1;8;24089
2020-06-03;León;Todos;Auxiliares sanitarios;874;60;5;55;24089
2020-06-03;León;Todos;Enfermero/a;1436;125;8;117;24089
2020-06-03;León;Todos;Médicos;826;81;4;77;24089
2020-06-03;León;Todos;Otros;8;0;0;0;24089
2020-06-03;León;Todos;Otros sanitarios;25;3;0;3;24089
2020-06-03;Palencia;Todos;Auxiliares sanitarios;104;21;4;17;34120
2020-06-03;Palencia;Todos;Celador;41;13;0;13;34120
2020-06-03;Palencia;Todos;Enfermero/a;174;42;4;38;34120
2020-06-03;Palencia;Todos;Médicos;147;30;0;30;34120
2020-06-03;Palencia;Todos;Otros;4;1;1;0;34120
2020-06-03;Palencia;Todos;Otros sanitarios;6;1;0;1;34120
2020-06-03;Palencia;Todos;Personal en formación;26;8;0;8;34120
2020-06-03;Palencia;Todos;Servicios de apoyo no sanitario;20;3;0;3;34120
2020-06-03;Salamanca;Todos;Celador;109;23;2;21;37274
2020-06-03;Salamanca;Todos;Fisioterapeuta;13;5;1;4;37274
2020-06-03;Salamanca;Todos;Otros;7;2;0;2;37274
2020-06-03;Salamanca;Todos;Otros sanitarios;10;4;2;2;37274
2020-06-03;Salamanca;Todos;Técnicos sanitarios;52;16;1;15;37274
2020-06-03;Segovia;Todos;Celador;86;21;1;20;40004
2020-06-03;Segovia;Todos;Fisioterapeuta;4;1;0;1;40004
2020-06-03;Segovia;Todos;Médicos;252;75;8;67;40004
2020-06-03;Soria;Todos;Celador;27;9;0;9;42173
2020-06-03;Soria;Todos;Enfermero/a;174;66;12;54;42173
2020-06-03;Soria;Todos;Fisioterapeuta;4;1;0;1;42173
2020-06-03;Soria;Todos;Personal en formación;10;2;1;1;42173
2020-06-03;Valladolid;Todos;Auxiliares sanitarios;472;68;1;67;47186
2020-06-03;Valladolid;Todos;Técnicos sanitarios;103;9;0;9;47186
2020-06-03;Zamora;Todos;Enfermero/a;130;21;2;19;49275
2020-06-03;Zamora;Todos;Otros;0;0;0;0;49275
2020-06-04;Ávila;Todos;Fisioterapeuta;8;0;0;0;5019
2020-06-04;Ávila;Todos;Técnicos sanitarios;35;5;3;2;5019
2020-06-04;Burgos;Todos;Enfermero/a;1176;83;0;83;9059
2020-06-04;Burgos;Todos;Otros;5;1;0;1;9059
2020-06-04;Burgos;Todos;Otros sanitarios;20;0;0;0;9059
2020-06-04;Burgos;Todos;Técnicos sanitarios;129;5;0;5;9059
2020-06-04;León;Todos;Celador;301;17;1;16;24089
2020-06-04;León;Todos;Técnicos sanitarios;218;7;0;7;24089
2020-06-04;Palencia;Todos;Enfermero/a;177;42;4;38;34120
2020-06-04;Palencia;Todos;Servicios de apoyo no sanitario;21;4;1;3;34120
2020-06-04;Palencia;Todos;Técnicos sanitarios;15;3;0;3;34120
2020-06-04;Salamanca;Todos;Enfermero/a;529;121;20;101;37274
2020-06-04;Salamanca;Todos;Fisioterapeuta;13;5;1;4;37274
2020-06-04;Salamanca;Todos;Técnicos sanitarios;53;16;1;15;37274
2020-06-04;Segovia;Todos;Celador;86;21;1;20;40004
2020-06-04;Segovia;Todos;Técnicos sanitarios;35;13;0;13;40004
2020-06-04;Soria;Todos;Administrativo;47;14;4;10;42173
2020-06-04;Soria;Todos;Enfermero/a;174;66;12;54;42173
2020-06-04;Soria;Todos;Servicios de apoyo no sanitario;17;3;1;2;42173
2020-06-04;Valladolid;Todos;Administrativo;169;22;1;21;47186
2020-06-04;Valladolid;Todos;Técnicos sanitarios;104;9;0;9;47186
2020-06-04;Zamora;Todos;Auxiliares sanitarios;56;5;0;5;49275
2020-06-04;Zamora;Todos;Enfermero/a;130;21;2;19;49275
2020-06-04;Zamora;Todos;Fisioterapeuta;4;0;0;0;49275
2020-06-04;Zamora;Todos;Servicios de apoyo no sanitario;5;0;0;0;49275
2020-06-05;Ávila;Todos;Enfermero/a;402;83;51;32;5019
2020-06-05;Ávila;Todos;Médicos;258;67;30;37;5019
2020-06-05;Ávila;Todos;Servicios de apoyo no sanitario;29;8;5;3;5019
2020-06-05;Burgos;Todos;Auxiliares sanitarios;766;51;2;49;9059
2020-06-05;Burgos;Todos;Médicos;710;58;7;51;9059
2020-06-05;Burgos;Todos;Técnicos sanitarios;129;5;0;5;9059
2020-06-05;León;Todos;Administrativo;306;9;1;8;24089
2020-06-05;León;Todos;Auxiliares sanitarios;920;61;5;56;24089
2020-06-05;León;Todos;Médicos;837;81;4;77;24089
2020-06-05;León;Todos;Otros;8;0;0;0;24089
2020-06-05;León;Todos;Servicios de apoyo no sanitario;157;4;0;4;24089
2020-06-05;Palencia;Todos;Auxiliares sanitarios;105;21;2;19;34120
2020-06-05;Palencia;Todos;Celador;41;13;0;13;34120
2020-06-05;Palencia;Todos;Enfermero/a;180;42;4;38;34120
2020-06-05;Palencia;Todos;Médicos;147;31;1;30;34120
2020-06-05;Palencia;Todos;Personal en formación;27;8;0;8;34120
2020-06-05;Palencia;Todos;Técnicos sanitarios;15;3;0;3;34120
2020-06-05;Salamanca;Todos;Otros;7;2;0;2;37274
2020-06-05;Salamanca;Todos;Personal en formación;104;24;6;18;37274
2020-06-05;Salamanca;Todos;Servicios de apoyo no sanitario;69;12;1;11;37274
2020-06-05;Segovia;Todos;Enfermero/a;352;122;2;120;40004
2020-06-05;Segovia;Todos;Otros sanitarios;6;1;1;0;40004
2020-06-05;Segovia;Todos;Personal en formación;43;13;1;12;40004
2020-06-05;Soria;Todos;Administrativo;48;15;5;10;42173
2020-06-05;Soria;Todos;Enfermero/a;178;67;12;55;42173
2020-06-05;Soria;Todos;Fisioterapeuta;4;1;0;1;42173
2020-06-05;Soria;Todos;Otros sanitarios;5;2;0;2;42173
2020-06-05;Soria;Todos;Técnicos sanitarios;15;8;0;8;42173
2020-06-05;Valladolid;Todos;Administrativo;170;22;1;21;47186
2020-06-05;Valladolid;Todos;Auxiliares sanitarios;475;69;2;67;47186
2020-06-05;Valladolid;Todos;Celador;138;23;3;20;47186
2020-06-05;Valladolid;Todos;Enfermero/a;990;153;5;148;47186
2020-06-05;Valladolid;Todos;Técnicos sanitarios;105;9;0;9;47186
2020-06-05;Zamora;Todos;Médicos;132;20;1;19;49275
2020-06-06;Ávila;Todos;Otros;3;1;0;1;5019
2020-06-06;Ávila;Todos;Otros sanitarios;10;5;3;2;5019
2020-06-06;Burgos;Todos;Administrativo;116;9;0;9;9059
2020-06-06;Burgos;Todos;Celador;227;15;1;14;9059
2020-06-06;Burgos;Todos;Enfermero/a;1236;84;1;83;9059
2020-06-06;Burgos;Todos;Fisioterapeuta;20;2;0;2;9059
2020-06-06;Burgos;Todos;Servicios de apoyo no sanitario;76;4;0;4;9059
2020-06-06;León;Todos;Auxiliares sanitarios;922;61;4;57;24089
2020-06-06;León;Todos;Celador;374;17;1;16;24089
2020-06-06;León;Todos;Fisioterapeuta;44;2;0;2;24089
2020-06-06;León;Todos;Servicios de apoyo no sanitario;158;4;0;4;24089
2020-06-06;Palencia;Todos;Administrativo;22;4;1;3;34120
2020-06-06;Palencia;Todos;Fisioterapeuta;5;2;0;2;34120
2020-06-06;Salamanca;Todos;Administrativo;92;20;3;17;37274
2020-06-06;Salamanca;Todos;Celador;110;24;3;21;37274
2020-06-06;Salamanca;Todos;Fisioterapeuta;13;5;0;5;37274
2020-06-06;Salamanca;Todos;Médicos;412;120;13;107;37274
2020-06-06;Salamanca;Todos;Otros sanitarios;10;4;2;2;37274
2020-06-06;Salamanca;Todos;Personal en formación;104;24;6;18;37274
2020-06-06;Salamanca;Todos;Servicios de apoyo no sanitario;70;12;1;11;37274
2020-06-06;Segovia;Todos;Auxiliares sanitarios;176;49;0;49;40004
2020-06-06;Segovia;Todos;Enfermero/a;352;122;2;120;40004
2020-06-06;Segovia;Todos;Médicos;254;75;8;67;40004
2020-06-06;Segovia;Todos;Técnicos sanitarios;36;13;0;13;40004
2020-06-06;Soria;Todos;Celador;28;9;0;9;42173
2020-06-06;Soria;Todos;Otros;0;0;0;0;42173
2020-06-06;Valladolid;Todos;Administrativo;170;22;1;21;47186
2020-06-06;Valladolid;Todos;Auxiliares sanitarios;475;69;2;67;47186
2020-06-06;Valladolid;Todos;Celador;138;23;3;20;47186
2020-06-06;Valladolid;Todos;Fisioterapeuta;25;3;0;3;47186
2020-06-06;Valladolid;Todos;Médicos;664;100;1;99;47186
2020-06-06;Valladolid;Todos;Personal en formación;145;22;0;22;47186
2020-06-06;Zamora;Todos;Celador;31;3;0;3;49275
2020-06-06;Zamora;Todos;Técnicos sanitarios;13;0;0;0;49275
2020-06-07;Ávila;Todos;Enfermero/a;402;83;50;33;5019
2020-06-07;Ávila;Todos;Servicios de apoyo no sanitario;29;8;5;3;5019
2020-06-07;Burgos;Todos;Administrativo;116;9;0;9;9059
2020-06-07;Burgos;Todos;Celador;227;15;1;14;9059
2020-06-07;Burgos;Todos;Enfermero/a;1236;84;1;83;9059
2020-06-07;Burgos;Todos;Fisioterapeuta;20;2;0;2;9059
2020-06-07;Burgos;Todos;Médicos;713;58;7;51;9059
2020-06-07;Burgos;Todos;Otros;6;1;0;1;9059
2020-06-07;Burgos;Todos;Personal en formación;148;6;1;5;9059
2020-06-07;Burgos;Todos;Servicios de apoyo no sanitario;76;4;0;4;9059
2020-06-07;León;Todos;Enfermero/a;1495;126;7;119;24089
2020-06-07;Palencia;Todos;Enfermero/a;180;42;4;38;34120
2020-06-07;Palencia;Todos;Otros;4;1;1;0;34120
2020-06-07;Salamanca;Todos;Administrativo;92;20;3;17;37274
2020-06-07;Salamanca;Todos;Auxiliares sanitarios;318;82;10;72;37274
2020-06-07;Salamanca;Todos;Celador;110;24;3;21;37274
2020-06-07;Salamanca;Todos;Enfermero/a;532;121;20;101;37274
2020-06-07;Salamanca;Todos;Fisioterapeuta;13;5;0;5;37274
2020-06-07;Salamanca;Todos;Personal en formación;104;24;6;18;37274
2020-06-07;Segovia;Todos;Celador;86;21;1;20;40004
2020-06-07;Segovia;Todos;Fisioterapeuta;4;1;0;1;40004
2020-06-07;Segovia;Todos;Médicos;254;75;8;67;40004
2020-06-07;Segovia;Todos;Otros;0;0;0;0;40004
2020-06-07;Segovia;Todos;Servicios de apoyo no sanitario;34;10;0;10;40004
2020-06-07;Soria;Todos;Auxiliares sanitarios;97;26;1;25;42173
2020-06-07;Soria;Todos;Celador;28;9;0;9;42173
2020-06-07;Valladolid;Todos;Celador;138;23;3;20;47186
2020-06-07;Valladolid;Todos;Fisioterapeuta;25;3;0;3;47186
2020-06-07;Valladolid;Todos;Médicos;664;100;1;99;47186
2020-06-07;Zamora;Todos;Auxiliares sanitarios;57;5;0;5;49275
2020-06-07;Zamora;Todos;Otros;0;0;0;0;49275
2020-06-08;Ávila;Emergencias sanitarias;Auxiliares sanitarios;0;0;0;0;5019
2020-06-08;Ávila;Emergencias sanitarias;Médicos;0;0;0;0;5019
2020-06-08;Ávila;Emergencias sanitarias;Otros sanitarios;0;0;0;0;5019
2020-06-08;Ávila;Emergencias sanitarias;Servicios de apoyo no sanitarios;0;0;0;0;5019
2020-06-08;Ávila;Especializada;Auxiliares sanitarios;237;68;23;45;5019
2020-06-08;Ávila;Especializada;Fisioterapeuta;6;0;0;0;5019
2020-06-08;Ávila;Especializada;Médicos;160;51;15;36;5019
2020-06-08;Ávila;Especializada;Personal en formación;9;0;0;0;5019
2020-06-08;Ávila;Especializada;Servicios de apoyo no sanitarios;29;14;5;9;5019
2020-06-08;Ávila;Primaria;Auxiliares sanitarios;3;3;0;3;5019
2020-06-08;Ávila;Primaria;Otros sanitarios;4;2;1;1;5019
2020-06-08;Ávila;Servicios centrales GRS;Celador;0;0;0;0;5019
2020-06-08;Ávila;Servicios centrales GRS;Otros sanitarios;0;0;0;0;5019
2020-06-08;Ávila;Servicios centrales GRS;Personal en formación;0;0;0;0;5019
2020-06-08;Burgos;Emergencias sanitarias;Servicios de apoyo no sanitarios;0;0;0;0;9059
2020-06-08;Burgos;Emergencias sanitarias;Técnicos sanitarios;0;0;0;0;9059
2020-06-08;Burgos;Especializada;Celador;249;39;0;39;9059
2020-06-08;Burgos;Especializada;Enfermero/a;1177;162;1;161;9059
2020-06-08;Burgos;Especializada;Médicos;602;87;6;81;9059
2020-06-08;Burgos;Especializada;Otros sanitarios;16;2;0;2;9059
2020-06-08;Burgos;Especializada;Técnicos sanitarios;125;20;0;20;9059
2020-06-08;Burgos;Primaria;Celador;8;3;0;3;9059
2020-06-08;Burgos;Primaria;Enfermero/a;99;20;0;20;9059
2020-06-08;Burgos;Primaria;Médicos;114;23;1;22;9059
2020-06-08;Burgos;Primaria;Otros;1;1;0;1;9059
2020-06-08;Burgos;Servicios centrales GRS;Administrativo;0;0;0;0;9059
2020-06-08;Burgos;Servicios centrales GRS;Fisioterapeuta;0;0;0;0;9059
2020-06-08;Burgos;Servicios centrales GRS;Médicos;0;0;0;0;9059
2020-06-08;Burgos;Servicios centrales GRS;Otros sanitarios;0;0;0;0;9059
2020-06-08;León;Emergencias sanitarias;Fisioterapeuta;0;0;0;0;24089
2020-06-08;León;Emergencias sanitarias;Médicos;0;0;0;0;24089
2020-06-08;León;Emergencias sanitarias;Personal en formación;0;0;0;0;24089
2020-06-08;León;Emergencias sanitarias;Técnicos sanitarios;0;0;0;0;24089
2020-06-08;León;Especializada;Administrativo;265;27;1;26;24089
2020-06-08;León;Especializada;Auxiliares sanitarios;923;134;5;129;24089
2020-06-08;León;Especializada;Celador;375;50;2;48;24089
2020-06-08;León;Especializada;Enfermero/a;1347;208;5;203;24089
2020-06-08;León;Especializada;Fisioterapeuta;36;4;0;4;24089
2020-06-08;León;Especializada;Servicios de apoyo no sanitarios;151;19;0;19;24089
2020-06-08;León;Especializada;Técnicos sanitarios;214;21;0;21;24089
2020-06-08;León;Primaria;Enfermero/a;183;49;2;47;24089
2020-06-08;León;Primaria;Fisioterapeuta;8;1;0;1;24089
2020-06-08;León;Primaria;Médicos;198;61;0;61;24089
2020-06-08;León;Primaria;Técnicos sanitarios;8;2;0;2;24089
2020-06-08;León;Servicios centrales GRS;Administrativo;0;0;0;0;24089
2020-06-08;León;Servicios centrales GRS;Celador;0;0;0;0;24089
2020-06-08;León;Servicios centrales GRS;Enfermero/a;0;0;0;0;24089
2020-06-08;León;Servicios centrales GRS;Médicos;0;0;0;0;24089
2020-06-08;León;Servicios centrales GRS;Otros sanitarios;0;0;0;0;24089
2020-06-08;León;Servicios centrales GRS;Servicios de apoyo no sanitarios;0;0;0;0;24089
2020-06-08;Palencia;Emergencias sanitarias;Auxiliares sanitarios;0;0;0;0;34120
2020-06-08;Palencia;Emergencias sanitarias;Enfermero/a;0;0;0;0;34120
2020-06-08;Palencia;Emergencias sanitarias;Médicos;0;0;0;0;34120
2020-06-08;Palencia;Especializada;Fisioterapeuta;2;0;0;0;34120
2020-06-08;Palencia;Especializada;Personal en formación;10;3;0;3;34120
2020-06-08;Palencia;Especializada;Técnicos sanitarios;15;3;0;3;34120
2020-06-08;Palencia;Primaria;Auxiliares sanitarios;6;2;1;1;34120
2020-06-08;Palencia;Primaria;Enfermero/a;63;23;3;20;34120
2020-06-08;Palencia;Primaria;Servicios de apoyo no sanitarios;3;3;1;2;34120
2020-06-08;Palencia;Primaria;Técnicos sanitarios;0;0;0;0;34120
2020-06-08;Palencia;Servicios centrales GRS;Administrativo;0;0;0;0;34120
2020-06-08;Palencia;Servicios centrales GRS;Celador;0;0;0;0;34120
2020-06-08;Palencia;Servicios centrales GRS;Enfermero/a;0;0;0;0;34120
2020-06-08;Palencia;Servicios centrales GRS;Otros sanitarios;0;0;0;0;34120
2020-06-08;Palencia;Servicios centrales GRS;Servicios de apoyo no sanitarios;0;0;0;0;34120
2020-06-08;Palencia;Servicios centrales GRS;Técnicos sanitarios;0;0;0;0;34120
2020-06-08;Salamanca;Emergencias sanitarias;Administrativo;0;0;0;0;37274
2020-06-08;Salamanca;Emergencias sanitarias;Auxiliares sanitarios;0;0;0;0;37274
2020-06-08;Salamanca;Emergencias sanitarias;Otros;0;0;0;0;37274
2020-06-08;Salamanca;Emergencias sanitarias;Servicios de apoyo no sanitarios;0;0;0;0;37274
2020-06-08;Salamanca;Especializada;Administrativo;68;18;1;17;37274
2020-06-08;Salamanca;Especializada;Otros;6;4;0;4;37274
2020-06-08;Salamanca;Especializada;Otros sanitarios;8;2;1;1;37274
2020-06-08;Salamanca;Especializada;Servicios de apoyo no sanitarios;69;17;1;16;37274
2020-06-08;Salamanca;Especializada;Técnicos sanitarios;52;20;1;19;37274
2020-06-08;Salamanca;Primaria;Auxiliares sanitarios;5;1;0;1;37274
2020-06-08;Salamanca;Primaria;Fisioterapeuta;2;2;0;2;37274
2020-06-08;Salamanca;Primaria;Técnicos sanitarios;2;1;0;1;37274
2020-06-08;Salamanca;Servicios centrales GRS;Administrativo;0;0;0;0;37274
2020-06-08;Salamanca;Servicios centrales GRS;Auxiliares sanitarios;0;0;0;0;37274
2020-06-08;Salamanca;Servicios centrales GRS;Celador;0;0;0;0;37274
2020-06-08;Salamanca;Servicios centrales GRS;Otros sanitarios;0;0;0;0;37274
2020-06-08;Salamanca;Servicios centrales GRS;Personal en formación;0;0;0;0;37274
2020-06-08;Salamanca;Servicios centrales GRS;Técnicos sanitarios;0;0;0;0;37274
2020-06-08;Segovia;Emergencias sanitarias;Administrativo;0;0;0;0;40004
2020-06-08;Segovia;Emergencias sanitarias;Celador;0;0;0;0;40004
2020-06-08;Segovia;Emergencias sanitarias;Otros;0;0;0;0;40004
2020-06-08;Segovia;Emergencias sanitarias;Personal en formación;0;0;0;0;40004
2020-06-08;Segovia;Emergencias sanitarias;Servicios de apoyo no sanitarios;0;0;0;0;40004
2020-06-08;Segovia;Especializada;Auxiliares sanitarios;170;80;0;80;40004
2020-06-08;Segovia;Especializada;Médicos;151;62;6;56;40004
2020-06-08;Segovia;Especializada;Otros;0;0;0;0;40004
2020-06-08;Segovia;Especializada;Personal en formación;31;15;1;14;40004
2020-06-08;Segovia;Especializada;Servicios de apoyo no sanitarios;32;20;0;20;40004
2020-06-08;Segovia;Primaria;Celador;5;3;0;3;40004
2020-06-08;Segovia;Primaria;Personal en formación;12;6;0;6;40004
2020-06-08;Segovia;Primaria;Servicios de apoyo no sanitarios;2;1;0;1;40004
2020-06-08;Segovia;Primaria;Técnicos sanitarios;2;0;0;0;40004
2020-06-08;Segovia;Servicios centrales GRS;Enfermero/a;0;0;0;0;40004
2020-06-08;Soria;Emergencias sanitarias;Administrativo;0;0;0;0;42173
2020-06-08;Soria;Emergencias sanitarias;Auxiliares sanitarios;0;0;0;0;42173
2020-06-08;Soria;Emergencias sanitarias;Celador;0;0;0;0;42173
2020-06-08;Soria;Emergencias sanitarias;Otros sanitarios;0;0;0;0;42173
2020-06-08;Soria;Emergencias sanitarias;Personal en formación;0;0;0;0;42173
2020-06-08;Soria;Especializada;Otros sanitarios;2;2;0;2;42173
2020-06-08;Soria;Especializada;Personal en formación;3;1;0;1;42173
2020-06-08;Soria;Especializada;Técnicos sanitarios;13;11;1;10;42173
2020-06-08;Soria;Primaria;Celador;2;2;0;2;42173
2020-06-08;Soria;Primaria;Fisioterapeuta;3;1;0;1;42173
2020-06-08;Soria;Primaria;Médicos;58;40;2;38;42173
2020-06-08;Soria;Primaria;Técnicos sanitarios;2;1;0;1;42173
2020-06-08;Soria;Servicios centrales GRS;Auxiliares sanitarios;0;0;0;0;42173
2020-06-08;Soria;Servicios centrales GRS;Personal en formación;0;0;0;0;42173
2020-06-08;Valladolid;Emergencias sanitarias;Administrativo;5;3;0;3;47186
2020-06-08;Valladolid;Emergencias sanitarias;Celador;0;0;0;0;47186
2020-06-08;Valladolid;Emergencias sanitarias;Servicios de apoyo no sanitarios;2;0;0;0;47186
2020-06-08;Valladolid;Especializada;Celador;134;45;3;42;47186
2020-06-08;Valladolid;Especializada;Otros;6;0;0;0;47186
2020-06-08;Valladolid;Especializada;Personal en formación;116;36;0;36;47186
2020-06-08;Valladolid;Especializada;Técnicos sanitarios;76;20;0;20;47186
2020-06-08;Valladolid;Primaria;Médicos;186;33;0;33;47186
2020-06-08;Valladolid;Primaria;Otros;0;0;0;0;47186
2020-06-08;Valladolid;Servicios centrales GRS;Otros;0;0;0;0;47186
2020-06-08;Zamora;Emergencias sanitarias;Administrativo;0;0;0;0;49275
2020-06-08;Zamora;Emergencias sanitarias;Celador;0;0;0;0;49275
2020-06-08;Zamora;Especializada;Administrativo;16;11;0;11;49275
2020-06-08;Zamora;Especializada;Auxiliares sanitarios;57;33;0;33;49275
2020-06-08;Zamora;Especializada;Enfermero/a;91;43;2;41;49275
2020-06-08;Zamora;Especializada;Otros sanitarios;2;0;0;0;49275
2020-06-08;Zamora;Primaria;Auxiliares sanitarios;1;0;0;0;49275
2020-06-08;Zamora;Primaria;Celador;3;1;0;1;49275
2020-06-08;Zamora;Primaria;Enfermero/a;42;12;0;12;49275
2020-06-08;Zamora;Primaria;Fisioterapeuta;2;0;0;0;49275
2020-06-08;Zamora;Primaria;Otros sanitarios;4;2;0;2;49275
2020-06-08;Zamora;Servicios centrales GRS;Celador;0;0;0;0;49275
2020-06-08;Zamora;Servicios centrales GRS;Personal en formación;0;0;0;0;49275
2020-06-08;Zamora;Servicios centrales GRS;Servicios de apoyo no sanitarios;0;0;0;0;49275
2020-06-08;Zamora;Servicios centrales GRS;Técnicos sanitarios;0;0;0;0;49275
2020-04-05;Ávila;Todos;Auxiliares sanitarios;71;33;33;0;5019
2020-04-05;Ávila;Todos;Celador;16;5;5;0;5019
2020-04-05;Ávila;Todos;Enfermero/a;156;70;69;1;5019
2020-04-05;Ávila;Todos;Otros;1;1;1;0;5019
2020-04-05;Ávila;Todos;Personal en formación;10;4;4;0;5019
2020-04-05;Ávila;Todos;Técnicos sanitarios;15;5;5;0;5019
2020-04-05;Burgos;Todos;Celador;18;7;7;0;9059
2020-04-05;Burgos;Todos;Fisioterapeuta;3;1;0;1;9059
2020-04-05;Burgos;Todos;Médicos;156;41;31;10;9059
2020-04-05;León;Todos;Administrativo;23;4;4;0;24089
2020-04-05;León;Todos;Celador;22;6;5;1;24089
2020-04-05;León;Todos;Enfermero/a;215;76;66;10;24089
2020-04-05;León;Todos;Fisioterapeuta;3;2;1;1;24089
2020-04-05;León;Todos;Médicos;206;66;52;14;24089
2020-04-05;León;Todos;Otros;1;0;0;0;24089
2020-04-05;León;Todos;Personal en formación;36;14;13;1;24089
2020-04-05;León;Todos;Servicios de apoyo no sanitario;7;2;2;0;24089
2020-04-05;Palencia;Todos;Enfermero/a;65;27;27;0;34120
2020-04-05;Palencia;Todos;Médicos;71;18;15;3;34120
2020-04-05;Palencia;Todos;Otros sanitarios;4;1;1;0;34120
2020-04-05;Palencia;Todos;Personal en formación;16;6;6;0;34120
2020-04-05;Salamanca;Todos;Técnicos sanitarios;32;14;14;0;37274
2020-04-05;Segovia;Todos;Administrativo;30;15;15;0;40004
2020-04-05;Segovia;Todos;Celador;25;16;15;1;40004
2020-04-05;Segovia;Todos;Enfermero/a;192;108;98;10;40004
2020-04-05;Segovia;Todos;Médicos;148;68;60;8;40004
2020-04-05;Segovia;Todos;Servicios de apoyo no sanitario;13;9;9;0;40004
2020-04-05;Soria;Todos;Celador;13;8;8;0;42173
2020-04-05;Soria;Todos;Otros;0;0;0;0;42173
2020-04-05;Valladolid;Todos;Auxiliares sanitarios;98;30;29;1;47186
2020-04-05;Valladolid;Todos;Enfermero/a;305;100;95;5;47186
2020-04-05;Valladolid;Todos;Servicios de apoyo no sanitario;19;7;7;0;47186
2020-04-05;Valladolid;Todos;Técnicos sanitarios;32;8;7;1;47186
2020-04-05;Zamora;Todos;Administrativo;4;1;1;0;49275
2020-04-05;Zamora;Todos;Celador;6;2;2;0;49275
2020-04-05;Zamora;Todos;Enfermero/a;47;14;12;2;49275
2020-04-05;Zamora;Todos;Médicos;55;17;10;7;49275
2020-04-05;Zamora;Todos;Otros sanitarios;1;1;1;0;49275
2020-04-05;Zamora;Todos;Servicios de apoyo no sanitario;0;0;0;0;49275
2020-04-05;Zamora;Todos;Técnicos sanitarios;2;0;0;0;49275
2020-04-06;Ávila;Todos;Enfermero/a;156;70;69;1;5019
2020-04-06;Ávila;Todos;Fisioterapeuta;2;0;0;0;5019
2020-04-06;Ávila;Todos;Personal en formación;10;4;4;0;5019
2020-04-06;Ávila;Todos;Técnicos sanitarios;15;5;5;0;5019
2020-04-06;Burgos;Todos;Enfermero/a;181;53;45;8;9059
2020-04-06;Burgos;Todos;Otros;0;0;0;0;9059
2020-04-06;Burgos;Todos;Personal en formación;15;4;3;1;9059
2020-04-06;León;Todos;Celador;28;9;8;1;24089
2020-04-06;León;Todos;Otros sanitarios;8;2;2;0;24089
2020-04-06;León;Todos;Servicios de apoyo no sanitario;7;2;2;0;24089
2020-04-06;León;Todos;Técnicos sanitarios;15;6;4;2;24089
2020-04-06;Palencia;Todos;Enfermero/a;67;28;28;0;34120
2020-04-06;Palencia;Todos;Otros sanitarios;4;1;1;0;34120
2020-04-06;Palencia;Todos;Técnicos sanitarios;2;1;1;0;34120
2020-04-06;Salamanca;Todos;Celador;41;14;14;0;37274
2020-04-06;Salamanca;Todos;Enfermero/a;241;91;87;4;37274
2020-04-06;Salamanca;Todos;Fisioterapeuta;6;4;4;0;37274
2020-04-06;Salamanca;Todos;Médicos;261;98;76;22;37274
2020-04-06;Salamanca;Todos;Otros;2;1;1;0;37274
2020-04-06;Segovia;Todos;Administrativo;31;15;14;1;40004
2020-04-06;Soria;Todos;Administrativo;17;11;11;0;42173
2020-04-06;Soria;Todos;Celador;14;9;9;0;42173
2020-04-06;Soria;Todos;Servicios de apoyo no sanitario;2;2;2;0;42173
2020-04-06;Valladolid;Todos;Administrativo;51;17;17;0;47186
2020-04-06;Valladolid;Todos;Auxiliares sanitarios;105;33;32;1;47186
2020-04-06;Valladolid;Todos;Fisioterapeuta;7;1;1;0;47186
2020-04-06;Valladolid;Todos;Médicos;346;83;65;18;47186
2020-04-06;Valladolid;Todos;Otros sanitarios;10;4;4;0;47186
2020-04-06;Valladolid;Todos;Técnicos sanitarios;34;9;8;1;47186
2020-04-06;Zamora;Todos;Auxiliares sanitarios;10;2;2;0;49275
2020-04-06;Zamora;Todos;Enfermero/a;52;15;11;4;49275
2020-04-06;Zamora;Todos;Fisioterapeuta;0;0;0;0;49275
2020-04-06;Zamora;Todos;Otros;0;0;0;0;49275
2020-04-06;Zamora;Todos;Servicios de apoyo no sanitario;0;0;0;0;49275
2020-04-06;Zamora;Todos;Técnicos sanitarios;2;0;0;0;49275
2020-04-07;Ávila;Todos;Fisioterapeuta;2;0;0;0;5019
2020-04-07;Ávila;Todos;Otros;1;1;1;0;5019
2020-04-07;Ávila;Todos;Técnicos sanitarios;15;5;5;0;5019
2020-04-07;Burgos;Todos;Administrativo;18;6;6;0;9059
2020-04-07;Burgos;Todos;Auxiliares sanitarios;92;30;26;4;9059
2020-04-07;Burgos;Todos;Celador;18;7;5;2;9059
2020-04-07;Burgos;Todos;Otros;0;0;0;0;9059
2020-04-07;Burgos;Todos;Personal en formación;15;4;3;1;9059
2020-04-07;León;Todos;Enfermero/a;244;91;76;15;24089
2020-04-07;León;Todos;Fisioterapeuta;4;2;1;1;24089
2020-04-07;León;Todos;Otros;1;0;0;0;24089
2020-04-07;León;Todos;Personal en formación;39;14;13;1;24089
2020-04-07;León;Todos;Técnicos sanitarios;15;6;4;2;24089
2020-04-07;Palencia;Todos;Fisioterapeuta;0;0;0;0;34120
2020-04-07;Palencia;Todos;Otros sanitarios;4;1;1;0;34120
2020-04-07;Palencia;Todos;Servicios de apoyo no sanitario;3;2;2;0;34120
2020-04-07;Palencia;Todos;Técnicos sanitarios;2;1;1;0;34120
2020-04-07;Salamanca;Todos;Enfermero/a;250;94;88;6;37274
2020-04-07;Salamanca;Todos;Fisioterapeuta;7;4;4;0;37274
2020-04-07;Salamanca;Todos;Personal en formación;41;16;10;6;37274
2020-04-07;Segovia;Todos;Celador;27;16;14;2;40004
2020-04-07;Segovia;Todos;Enfermero/a;206;111;94;17;40004
2020-04-07;Segovia;Todos;Otros sanitarios;2;1;1;0;40004
2020-04-07;Segovia;Todos;Personal en formación;18;9;8;1;40004
2020-04-07;Soria;Todos;Celador;14;9;9;0;42173
2020-04-07;Soria;Todos;Enfermero/a;89;54;39;15;42173
2020-04-07;Soria;Todos;Médicos;79;49;38;11;42173
2020-04-07;Soria;Todos;Servicios de apoyo no sanitario;2;2;2;0;42173
2020-04-07;Valladolid;Todos;Administrativo;54;18;18;0;47186
2020-04-07;Valladolid;Todos;Celador;46;18;17;1;47186
2020-04-07;Valladolid;Todos;Médicos;358;87;63;24;47186
2020-04-07;Valladolid;Todos;Otros;0;0;0;0;47186
2020-04-07;Valladolid;Todos;Servicios de apoyo no sanitario;24;7;7;0;47186
2020-04-07;Zamora;Todos;Auxiliares sanitarios;10;2;2;0;49275
2020-04-07;Zamora;Todos;Enfermero/a;56;15;11;4;49275
2020-04-07;Zamora;Todos;Médicos;62;19;11;8;49275
2020-04-07;Zamora;Todos;Otros;0;0;0;0;49275
2020-04-07;Zamora;Todos;Otros sanitarios;2;1;1;0;49275
2020-04-08;Ávila;Todos;Celador;18;5;5;0;5019
2020-04-08;Ávila;Todos;Fisioterapeuta;2;0;0;0;5019
2020-04-08;Burgos;Todos;Enfermero/a;194;59;42;17;9059
2020-04-08;Burgos;Todos;Fisioterapeuta;3;1;0;1;9059
2020-04-08;Burgos;Todos;Médicos;171;45;24;21;9059
2020-04-08;Burgos;Todos;Otros;0;0;0;0;9059
2020-04-08;Burgos;Todos;Personal en formación;17;4;3;1;9059
2020-04-08;Burgos;Todos;Servicios de apoyo no sanitario;3;1;0;1;9059
2020-04-08;Burgos;Todos;Técnicos sanitarios;12;4;1;3;9059
2020-04-08;León;Todos;Administrativo;27;5;3;2;24089
2020-04-08;León;Todos;Auxiliares sanitarios;100;32;29;3;24089
2020-04-08;León;Todos;Enfermero/a;272;96;81;15;24089
2020-04-08;León;Todos;Médicos;241;68;47;21;24089
2020-04-08;León;Todos;Otros sanitarios;9;2;2;0;24089
2020-04-08;Palencia;Todos;Celador;18;10;9;1;34120
2020-04-08;Palencia;Todos;Enfermero/a;71;31;30;1;34120
2020-04-08;Palencia;Todos;Técnicos sanitarios;3;2;2;0;34120
2020-04-08;Salamanca;Todos;Otros;2;1;1;0;37274
2020-04-08;Salamanca;Todos;Personal en formación;42;16;10;6;37274
2020-04-08;Segovia;Todos;Administrativo;33;16;14;2;40004
2020-04-08;Segovia;Todos;Celador;28;17;15;2;40004
2020-04-08;Segovia;Todos;Fisioterapeuta;3;1;0;1;40004
2020-04-08;Segovia;Todos;Personal en formación;18;9;8;1;40004
2020-04-08;Segovia;Todos;Técnicos sanitarios;22;13;11;2;40004
2020-04-08;Soria;Todos;Administrativo;19;12;12;0;42173
2020-04-08;Soria;Todos;Auxiliares sanitarios;42;22;19;3;42173
2020-04-08;Soria;Todos;Celador;15;9;8;1;42173
2020-04-08;Soria;Todos;Médicos;86;51;38;13;42173
2020-04-08;Soria;Todos;Técnicos sanitarios;11;8;6;2;42173
2020-04-08;Valladolid;Todos;Auxiliares sanitarios;125;37;33;4;47186
2020-04-08;Valladolid;Todos;Fisioterapeuta;8;2;2;0;47186
2020-04-08;Valladolid;Todos;Personal en formación;73;17;12;5;47186
2020-04-08;Zamora;Todos;Administrativo;4;1;0;1;49275
2020-04-08;Zamora;Todos;Auxiliares sanitarios;11;2;2;0;49275
2020-04-08;Zamora;Todos;Enfermero/a;58;15;11;4;49275
2020-04-08;Zamora;Todos;Fisioterapeuta;0;0;0;0;49275
2020-04-08;Zamora;Todos;Otros sanitarios;2;1;1;0;49275
2020-04-09;Ávila;Todos;Administrativo;19;15;14;1;5019
2020-04-09;Ávila;Todos;Celador;19;5;5;0;5019
2020-04-09;Ávila;Todos;Médicos;154;61;45;16;5019
2020-04-09;Ávila;Todos;Otros sanitarios;9;5;5;0;5019
2020-04-09;Burgos;Todos;Auxiliares sanitarios;97;31;24;7;9059
2020-04-09;Burgos;Todos;Otros;0;0;0;0;9059
2020-04-09;Burgos;Todos;Otros sanitarios;4;0;0;0;9059
2020-04-09;Burgos;Todos;Personal en formación;18;4;3;1;9059
2020-04-09;Burgos;Todos;Técnicos sanitarios;13;4;1;3;9059
2020-04-09;León;Todos;Auxiliares sanitarios;112;36;33;3;24089
2020-04-09;León;Todos;Fisioterapeuta;4;2;0;2;24089
2020-04-09;León;Todos;Médicos;258;70;49;21;24089
2020-04-09;León;Todos;Otros sanitarios;11;3;3;0;24089
2020-04-09;León;Todos;Técnicos sanitarios;20;6;4;2;24089
2020-04-09;Palencia;Todos;Administrativo;9;3;3;0;34120
2020-04-09;Salamanca;Todos;Otros;2;1;1;0;37274
2020-04-09;Salamanca;Todos;Otros sanitarios;5;4;4;0;37274
2020-04-09;Salamanca;Todos;Servicios de apoyo no sanitario;22;11;8;3;37274
2020-04-09;Segovia;Todos;Fisioterapeuta;3;1;0;1;40004
2020-04-09;Segovia;Todos;Otros;0;0;0;0;40004
2020-04-09;Segovia;Todos;Otros sanitarios;2;1;1;0;40004
2020-04-09;Segovia;Todos;Personal en formación;18;9;7;2;40004
2020-04-09;Soria;Todos;Fisioterapeuta;2;1;1;0;42173
2020-04-09;Soria;Todos;Personal en formación;9;2;1;1;42173
2020-04-09;Valladolid;Todos;Administrativo;65;19;18;1;47186
2020-04-09;Valladolid;Todos;Otros;0;0;0;0;47186
2020-04-09;Valladolid;Todos;Técnicos sanitarios;42;9;6;3;47186
2020-04-09;Zamora;Todos;Auxiliares sanitarios;11;2;2;0;49275
2020-04-09;Zamora;Todos;Médicos;65;19;9;10;49275
2020-04-09;Zamora;Todos;Otros sanitarios;2;1;1;0;49275
2020-04-09;Zamora;Todos;Personal en formación;1;0;0;0;49275
2020-04-10;Ávila;Todos;Auxiliares sanitarios;81;36;33;3;5019
2020-04-10;Ávila;Todos;Fisioterapeuta;5;0;0;0;5019
2020-04-10;Ávila;Todos;Médicos;157;61;44;17;5019
2020-04-10;Ávila;Todos;Otros sanitarios;9;5;5;0;5019
2020-04-10;Ávila;Todos;Técnicos sanitarios;17;7;5;2;5019
2020-04-10;Burgos;Todos;Personal en formación;19;4;0;4;9059
2020-04-10;León;Todos;Auxiliares sanitarios;121;37;34;3;24089
2020-04-10;León;Todos;Otros;1;0;0;0;24089
2020-04-10;León;Todos;Otros sanitarios;12;3;3;0;24089
2020-04-10;León;Todos;Técnicos sanitarios;20;6;4;2;24089
2020-04-10;Palencia;Todos;Administrativo;9;3;3;0;34120
2020-04-10;Palencia;Todos;Celador;19;11;9;2;34120
2020-04-10;Palencia;Todos;Enfermero/a;82;35;31;4;34120
2020-04-10;Palencia;Todos;Fisioterapeuta;0;0;0;0;34120
2020-04-10;Palencia;Todos;Médicos;87;21;12;9;34120
2020-04-10;Palencia;Todos;Otros;1;0;0;0;34120
2020-04-10;Salamanca;Todos;Administrativo;34;16;13;3;37274
2020-04-10;Salamanca;Todos;Celador;47;17;14;3;37274
2020-04-10;Salamanca;Todos;Fisioterapeuta;7;4;4;0;37274
2020-04-10;Salamanca;Todos;Otros;3;1;1;0;37274
2020-04-10;Salamanca;Todos;Otros sanitarios;5;4;4;0;37274
2020-04-10;Salamanca;Todos;Personal en formación;50;20;9;11;37274
2020-04-10;Salamanca;Todos;Servicios de apoyo no sanitario;24;11;7;4;37274
2020-04-10;Segovia;Todos;Enfermero/a;216;115;87;28;40004
2020-04-10;Segovia;Todos;Médicos;163;71;44;27;40004
2020-04-10;Segovia;Todos;Otros sanitarios;2;1;1;0;40004
2020-04-10;Segovia;Todos;Técnicos sanitarios;22;13;10;3;40004
2020-04-10;Soria;Todos;Administrativo;23;12;8;4;42173
2020-04-10;Soria;Todos;Enfermero/a;105;62;38;24;42173
2020-04-10;Soria;Todos;Fisioterapeuta;2;1;1;0;42173
2020-04-10;Soria;Todos;Médicos;91;51;29;22;42173
2020-04-10;Valladolid;Todos;Administrativo;68;20;18;2;47186
2020-04-10;Valladolid;Todos;Celador;51;17;15;2;47186
2020-04-10;Valladolid;Todos;Enfermero/a;424;120;102;18;47186
2020-04-10;Valladolid;Todos;Fisioterapeuta;11;3;3;0;47186
2020-04-10;Valladolid;Todos;Otros sanitarios;11;4;3;1;47186
2020-04-10;Valladolid;Todos;Técnicos sanitarios;43;9;6;3;47186
2020-04-10;Zamora;Todos;Celador;8;2;2;0;49275
2020-04-10;Zamora;Todos;Otros;0;0;0;0;49275
2020-04-10;Zamora;Todos;Personal en formación;1;0;0;0;49275
2020-04-11;Ávila;Todos;Fisioterapeuta;5;0;0;0;5019
2020-04-11;Ávila;Todos;Médicos;160;63;46;17;5019
2020-04-11;Ávila;Todos;Otros sanitarios;9;5;5;0;5019
2020-04-11;Ávila;Todos;Técnicos sanitarios;17;7;6;1;5019
2020-04-11;Burgos;Todos;Administrativo;23;7;7;0;9059
2020-04-11;Burgos;Todos;Enfermero/a;221;62;40;22;9059
2020-04-11;Burgos;Todos;Fisioterapeuta;4;1;0;1;9059
2020-04-11;Burgos;Todos;Personal en formación;19;4;0;4;9059
2020-04-11;León;Todos;Administrativo;75;12;7;5;24089
2020-04-11;León;Todos;Celador;65;9;7;2;24089
2020-04-11;León;Todos;Enfermero/a;427;110;86;24;24089
2020-04-11;León;Todos;Médicos;362;81;52;29;24089
2020-04-11;León;Todos;Otros sanitarios;17;3;3;0;24089
2020-04-11;Palencia;Todos;Auxiliares sanitarios;43;14;13;1;34120
2020-04-11;Palencia;Todos;Celador;20;11;9;2;34120
2020-04-11;Palencia;Todos;Otros sanitarios;4;1;0;1;34120
2020-04-11;Salamanca;Todos;Administrativo;34;16;13;3;37274
2020-04-11;Salamanca;Todos;Fisioterapeuta;7;4;4;0;37274
2020-04-11;Salamanca;Todos;Médicos;289;109;65;44;37274
2020-04-11;Salamanca;Todos;Otros sanitarios;6;4;4;0;37274
2020-04-11;Salamanca;Todos;Técnicos sanitarios;36;17;15;2;37274
2020-04-11;Segovia;Todos;Administrativo;33;16;11;5;40004
2020-04-11;Segovia;Todos;Médicos;165;71;44;27;40004
2020-04-11;Segovia;Todos;Otros sanitarios;2;1;1;0;40004
2020-04-11;Segovia;Todos;Servicios de apoyo no sanitario;15;9;9;0;40004
2020-04-11;Soria;Todos;Médicos;91;51;27;24;42173
2020-04-11;Soria;Todos;Técnicos sanitarios;12;8;5;3;42173
2020-04-11;Valladolid;Todos;Técnicos sanitarios;43;9;6;3;47186
2020-04-11;Zamora;Todos;Médicos;68;19;8;11;49275
2020-04-11;Zamora;Todos;Otros sanitarios;2;1;1;0;49275
2020-04-12;Ávila;Todos;Administrativo;20;15;13;2;5019
2020-04-12;Ávila;Todos;Médicos;160;63;46;17;5019
2020-04-12;Ávila;Todos;Otros;1;1;0;1;5019
2020-04-12;Ávila;Todos;Otros sanitarios;9;5;5;0;5019
2020-04-12;Ávila;Todos;Personal en formación;10;4;3;1;5019
2020-04-12;Burgos;Todos;Administrativo;24;7;7;0;9059
2020-04-12;Burgos;Todos;Celador;23;10;7;3;9059
2020-04-12;Burgos;Todos;Enfermero/a;228;64;41;23;9059
2020-04-12;Burgos;Todos;Médicos;193;49;25;24;9059
2020-04-12;Burgos;Todos;Otros sanitarios;6;0;0;0;9059
2020-04-12;Burgos;Todos;Personal en formación;19;4;0;4;9059
2020-04-12;Palencia;Todos;Auxiliares sanitarios;44;14;13;1;34120
2020-04-12;Palencia;Todos;Otros sanitarios;4;1;0;1;34120
2020-04-12;Palencia;Todos;Servicios de apoyo no sanitario;7;3;3;0;34120
2020-04-12;Salamanca;Todos;Auxiliares sanitarios;148;61;52;9;37274
2020-04-12;Salamanca;Todos;Médicos;289;109;65;44;37274
2020-04-12;Salamanca;Todos;Otros sanitarios;6;4;4;0;37274
2020-04-12;Segovia;Todos;Fisioterapeuta;3;1;0;1;40004
2020-04-12;Segovia;Todos;Personal en formación;19;9;7;2;40004
2020-04-12;Segovia;Todos;Técnicos sanitarios;22;13;10;3;40004
2020-04-12;Soria;Todos;Administrativo;23;12;8;4;42173
2020-04-12;Soria;Todos;Auxiliares sanitarios;49;22;14;8;42173
2020-04-12;Soria;Todos;Celador;16;10;7;3;42173
2020-04-12;Soria;Todos;Fisioterapeuta;2;1;1;0;42173
2020-04-12;Valladolid;Todos;Técnicos sanitarios;43;9;6;3;47186
2020-04-12;Zamora;Todos;Otros sanitarios;2;1;1;0;49275
2020-04-13;Ávila;Todos;Médicos;163;65;45;20;5019
2020-04-13;Ávila;Todos;Otros;1;1;0;1;5019
2020-04-13;Burgos;Todos;Auxiliares sanitarios;126;35;25;10;9059
2020-04-13;Burgos;Todos;Fisioterapeuta;8;1;0;1;9059
2020-04-13;Burgos;Todos;Médicos;227;50;24;26;9059
2020-04-13;Burgos;Todos;Otros;1;1;0;1;9059
2020-04-13;Palencia;Todos;Celador;28;11;9;2;34120
2020-04-13;Palencia;Todos;Médicos;104;21;11;10;34120
2020-04-13;Palencia;Todos;Personal en formación;18;6;3;3;34120
2020-04-13;Salamanca;Todos;Celador;52;18;15;3;37274
2020-04-13;Salamanca;Todos;Enfermero/a;306;105;88;17;37274
2020-04-13;Salamanca;Todos;Otros;3;1;1;0;37274
2020-04-13;Segovia;Todos;Enfermero/a;230;118;75;43;40004
2020-04-13;Segovia;Todos;Servicios de apoyo no sanitario;15;9;7;2;40004
2020-04-13;Soria;Todos;Auxiliares sanitarios;49;22;14;8;42173
2020-04-13;Soria;Todos;Celador;16;10;7;3;42173
2020-04-13;Valladolid;Todos;Administrativo;81;22;18;4;47186
2020-04-13;Valladolid;Todos;Enfermero/a;484;123;98;25;47186
2020-04-13;Valladolid;Todos;Otros sanitarios;12;4;3;1;47186
2020-04-13;Valladolid;Todos;Técnicos sanitarios;46;9;6;3;47186
2020-04-13;Zamora;Todos;Administrativo;7;3;1;2;49275
2020-04-13;Zamora;Todos;Médicos;71;19;8;11;49275
2020-04-13;Zamora;Todos;Otros;0;0;0;0;49275
2020-04-13;Zamora;Todos;Servicios de apoyo no sanitario;0;0;0;0;49275
2020-04-14;Ávila;Todos;Celador;22;5;5;0;5019
2020-04-14;Ávila;Todos;Fisioterapeuta;5;0;0;0;5019
2020-04-14;Ávila;Todos;Médicos;164;66;45;21;5019
2020-04-14;Ávila;Todos;Personal en formación;10;4;3;1;5019
2020-04-14;Burgos;Todos;Fisioterapeuta;14;1;0;1;9059
2020-04-14;Burgos;Todos;Médicos;307;51;22;29;9059
2020-04-14;Burgos;Todos;Otros sanitarios;8;0;0;0;9059
2020-04-14;Burgos;Todos;Servicios de apoyo no sanitario;6;2;1;1;9059
2020-04-14;Burgos;Todos;Técnicos sanitarios;21;4;1;3;9059
2020-04-14;León;Todos;Celador;78;13;11;2;24089
2020-04-14;León;Todos;Enfermero/a;598;120;83;37;24089
2020-04-14;León;Todos;Fisioterapeuta;13;2;0;2;24089
2020-04-14;León;Todos;Servicios de apoyo no sanitario;9;2;0;2;24089
2020-04-14;Palencia;Todos;Administrativo;40;3;3;0;34120
2020-04-14;Palencia;Todos;Celador;29;11;9;2;34120
2020-04-14;Palencia;Todos;Otros sanitarios;7;1;0;1;34120
2020-04-14;Palencia;Todos;Personal en formación;18;6;3;3;34120
2020-04-14;Palencia;Todos;Técnicos sanitarios;5;3;3;0;34120
2020-04-14;Salamanca;Todos;Otros sanitarios;6;4;4;0;37274
2020-04-14;Segovia;Todos;Técnicos sanitarios;26;13;8;5;40004
2020-04-14;Soria;Todos;Administrativo;23;12;6;6;42173
2020-04-14;Soria;Todos;Celador;16;10;7;3;42173
2020-04-14;Soria;Todos;Fisioterapeuta;2;1;1;0;42173
2020-04-14;Soria;Todos;Otros sanitarios;3;2;2;0;42173
2020-04-14;Soria;Todos;Personal en formación;10;2;1;1;42173
2020-04-14;Soria;Todos;Servicios de apoyo no sanitario;2;2;2;0;42173
2020-04-14;Valladolid;Todos;Administrativo;116;23;20;3;47186
2020-04-14;Valladolid;Todos;Celador;67;18;15;3;47186
2020-04-14;Valladolid;Todos;Enfermero/a;584;128;102;26;47186
2020-04-14;Valladolid;Todos;Fisioterapeuta;28;3;3;0;47186
2020-04-14;Valladolid;Todos;Médicos;545;99;54;45;47186
2020-04-14;Valladolid;Todos;Personal en formación;118;20;12;8;47186
2020-04-14;Valladolid;Todos;Servicios de apoyo no sanitario;34;8;5;3;47186
2020-04-14;Zamora;Todos;Administrativo;7;4;2;2;49275
2020-04-14;Zamora;Todos;Auxiliares sanitarios;14;3;3;0;49275
2020-04-14;Zamora;Todos;Celador;11;2;2;0;49275
2020-04-14;Zamora;Todos;Enfermero/a;67;20;15;5;49275
2020-04-14;Zamora;Todos;Otros;0;0;0;0;49275
2020-04-14;Zamora;Todos;Técnicos sanitarios;4;0;0;0;49275
2020-04-15;Ávila;Todos;Personal en formación;10;4;3;1;5019
2020-04-15;Burgos;Todos;Auxiliares sanitarios;139;36;23;13;9059
2020-04-15;Burgos;Todos;Enfermero/a;397;67;36;31;9059
2020-04-15;Burgos;Todos;Fisioterapeuta;14;1;0;1;9059
2020-04-15;Burgos;Todos;Médicos;340;52;24;28;9059
2020-04-15;Burgos;Todos;Personal en formación;25;4;0;4;9059
2020-04-15;Burgos;Todos;Técnicos sanitarios;23;4;1;3;9059
2020-04-15;León;Todos;Administrativo;90;13;6;7;24089
2020-04-15;León;Todos;Enfermero/a;626;123;84;39;24089
2020-04-15;León;Todos;Personal en formación;78;15;11;4;24089
2020-04-15;León;Todos;Técnicos sanitarios;34;6;4;2;24089
2020-04-15;Salamanca;Todos;Celador;54;20;17;3;37274
2020-04-15;Salamanca;Todos;Enfermero/a;340;109;82;27;37274
2020-04-15;Segovia;Todos;Administrativo;36;16;8;8;40004
2020-04-15;Segovia;Todos;Personal en formación;23;10;6;4;40004
2020-04-15;Soria;Todos;Administrativo;23;12;6;6;42173
2020-04-15;Soria;Todos;Servicios de apoyo no sanitario;3;2;2;0;42173
2020-04-15;Valladolid;Todos;Celador;71;18;15;3;47186
2020-04-15;Valladolid;Todos;Servicios de apoyo no sanitario;35;8;5;3;47186
2020-04-15;Zamora;Todos;Personal en formación;2;0;0;0;49275
2020-04-15;Zamora;Todos;Servicios de apoyo no sanitario;0;0;0;0;49275
2020-04-16;Ávila;Todos;Técnicos sanitarios;19;7;6;1;5019
2020-04-16;Burgos;Todos;Auxiliares sanitarios;142;37;21;16;9059
2020-04-16;Burgos;Todos;Celador;50;11;6;5;9059
2020-04-16;Burgos;Todos;Enfermero/a;424;69;36;33;9059
2020-04-16;Burgos;Todos;Fisioterapeuta;16;1;0;1;9059
2020-04-16;Burgos;Todos;Médicos;370;52;24;28;9059
2020-04-16;Burgos;Todos;Servicios de apoyo no sanitario;10;2;1;1;9059
2020-04-16;León;Todos;Médicos;501;88;46;42;24089
2020-04-16;León;Todos;Otros;3;0;0;0;24089
2020-04-16;León;Todos;Otros sanitarios;23;3;3;0;24089
2020-04-16;Palencia;Todos;Auxiliares sanitarios;52;14;13;1;34120
2020-04-16;Palencia;Todos;Celador;30;11;9;2;34120
2020-04-16;Palencia;Todos;Enfermero/a;143;40;32;8;34120
2020-04-16;Palencia;Todos;Fisioterapeuta;3;0;0;0;34120
2020-04-16;Palencia;Todos;Otros sanitarios;7;1;0;1;34120
2020-04-16;Salamanca;Todos;Auxiliares sanitarios;173;68;48;20;37274
2020-04-16;Salamanca;Todos;Médicos;316;115;57;58;37274
2020-04-16;Salamanca;Todos;Otros;3;1;1;0;37274
2020-04-16;Salamanca;Todos;Personal en formación;61;22;10;12;37274
2020-04-16;Salamanca;Todos;Técnicos sanitarios;38;17;12;5;37274
2020-04-16;Segovia;Todos;Administrativo;37;16;6;10;40004
2020-04-16;Segovia;Todos;Enfermero/a;246;121;54;67;40004
2020-04-16;Segovia;Todos;Fisioterapeuta;4;1;0;1;40004
2020-04-16;Segovia;Todos;Otros;0;0;0;0;40004
2020-04-16;Segovia;Todos;Otros sanitarios;2;1;1;0;40004
2020-04-16;Segovia;Todos;Técnicos sanitarios;28;13;7;6;40004
2020-04-16;Soria;Todos;Administrativo;23;12;6;6;42173
2020-04-16;Soria;Todos;Auxiliares sanitarios;52;22;9;13;42173
2020-04-16;Soria;Todos;Celador;17;10;6;4;42173
2020-04-16;Soria;Todos;Enfermero/a;113;64;34;30;42173
2020-04-16;Soria;Todos;Otros;0;0;0;0;42173
2020-04-16;Soria;Todos;Personal en formación;10;2;1;1;42173
2020-04-16;Soria;Todos;Servicios de apoyo no sanitario;3;2;1;1;42173
2020-04-16;Soria;Todos;Técnicos sanitarios;12;8;4;4;42173
2020-04-16;Valladolid;Todos;Enfermero/a;655;130;96;34;47186
2020-04-16;Valladolid;Todos;Fisioterapeuta;31;3;3;0;47186
2020-04-16;Valladolid;Todos;Médicos;627;102;51;51;47186
2020-04-16;Valladolid;Todos;Personal en formación;141;22;12;10;47186
2020-04-16;Valladolid;Todos;Técnicos sanitarios;56;9;5;4;47186
2020-04-16;Zamora;Todos;Auxiliares sanitarios;15;4;4;0;49275
2020-04-16;Zamora;Todos;Médicos;73;20;6;14;49275
2020-04-16;Zamora;Todos;Personal en formación;2;0;0;0;49275
2020-04-17;Ávila;Todos;Administrativo;24;16;11;5;5019
2020-04-17;Ávila;Todos;Enfermero/a;202;80;66;14;5019
2020-04-17;Ávila;Todos;Otros;1;1;0;1;5019
2020-04-17;Ávila;Todos;Servicios de apoyo no sanitario;21;9;7;2;5019
2020-04-17;Burgos;Todos;Auxiliares sanitarios;148;37;20;17;9059
2020-04-17;Burgos;Todos;Médicos;379;52;22;30;9059
2020-04-17;Burgos;Todos;Servicios de apoyo no sanitario;11;2;1;1;9059
2020-04-17;León;Todos;Celador;90;14;10;4;24089
2020-04-17;León;Todos;Otros sanitarios;23;3;3;0;24089
2020-04-17;León;Todos;Técnicos sanitarios;38;6;4;2;24089
2020-04-17;Palencia;Todos;Enfermero/a;151;40;32;8;34120
2020-04-17;Palencia;Todos;Fisioterapeuta;5;0;0;0;34120
2020-04-17;Palencia;Todos;Técnicos sanitarios;5;3;3;0;34120
2020-04-17;Salamanca;Todos;Auxiliares sanitarios;187;70;44;26;37274
2020-04-17;Salamanca;Todos;Servicios de apoyo no sanitario;29;13;6;7;37274
2020-04-17;Salamanca;Todos;Técnicos sanitarios;39;17;11;6;37274
2020-04-17;Segovia;Todos;Auxiliares sanitarios;97;46;32;14;40004
2020-04-17;Segovia;Todos;Fisioterapeuta;4;1;0;1;40004
2020-04-17;Segovia;Todos;Médicos;187;77;27;50;40004
2020-04-17;Segovia;Todos;Otros;0;0;0;0;40004
2020-04-17;Soria;Todos;Enfermero/a;122;65;34;31;42173
2020-04-17;Soria;Todos;Médicos;106;53;24;29;42173
2020-04-17;Soria;Todos;Otros sanitarios;3;2;1;1;42173
2020-04-17;Soria;Todos;Técnicos sanitarios;13;8;4;4;42173
2020-04-17;Valladolid;Todos;Médicos;674;104;44;60;47186
2020-04-17;Valladolid;Todos;Otros sanitarios;18;4;1;3;47186
2020-04-17;Zamora;Todos;Médicos;73;20;5;15;49275
2020-04-17;Zamora;Todos;Servicios de apoyo no sanitario;0;0;0;0;49275
2020-04-17;Zamora;Todos;Técnicos sanitarios;4;0;0;0;49275
2020-04-18;Ávila;Todos;Auxiliares sanitarios;94;37;34;3;5019
2020-04-18;Ávila;Todos;Enfermero/a;202;80;66;14;5019
2020-04-18;Ávila;Todos;Servicios de apoyo no sanitario;21;9;7;2;5019
2020-04-18;Burgos;Todos;Celador;54;11;5;6;9059
2020-04-18;Burgos;Todos;Enfermero/a;443;71;35;36;9059
2020-04-18;Burgos;Todos;Otros;7;1;0;1;9059
2020-04-18;Burgos;Todos;Personal en formación;29;4;0;4;9059
2020-04-18;León;Todos;Técnicos sanitarios;39;6;4;2;24089
2020-04-18;Palencia;Todos;Administrativo;52;4;4;0;34120
2020-04-18;Palencia;Todos;Celador;31;11;9;2;34120
2020-04-18;Palencia;Todos;Otros;2;0;0;0;34120
2020-04-18;Palencia;Todos;Personal en formación;18;6;3;3;34120
2020-04-18;Salamanca;Todos;Celador;59;22;17;5;37274
2020-04-18;Salamanca;Todos;Enfermero/a;399;116;66;50;37274
2020-04-18;Salamanca;Todos;Médicos;336;118;50;68;37274
2020-04-18;Salamanca;Todos;Otros;3;1;1;0;37274
2020-04-18;Segovia;Todos;Administrativo;38;16;5;11;40004
2020-04-18;Segovia;Todos;Celador;39;18;10;8;40004
2020-04-18;Segovia;Todos;Enfermero/a;256;122;49;73;40004
2020-04-18;Segovia;Todos;Otros;0;0;0;0;40004
2020-04-18;Segovia;Todos;Personal en formación;24;10;4;6;40004
2020-04-18;Segovia;Todos;Servicios de apoyo no sanitario;16;9;5;4;40004
2020-04-18;Soria;Todos;Celador;17;10;6;4;42173
2020-04-18;Soria;Todos;Enfermero/a;126;65;31;34;42173
2020-04-18;Soria;Todos;Fisioterapeuta;3;1;0;1;42173
2020-04-18;Soria;Todos;Médicos;107;53;23;30;42173
2020-04-18;Soria;Todos;Personal en formación;10;2;1;1;42173
2020-04-18;Valladolid;Todos;Celador;88;18;14;4;47186
2020-04-18;Valladolid;Todos;Fisioterapeuta;34;3;2;1;47186
2020-04-18;Valladolid;Todos;Médicos;677;104;44;60;47186
2020-04-18;Valladolid;Todos;Otros;3;0;0;0;47186
2020-04-18;Valladolid;Todos;Servicios de apoyo no sanitario;37;8;4;4;47186
2020-04-18;Zamora;Todos;Enfermero/a;71;20;16;4;49275
2020-04-18;Zamora;Todos;Otros;0;0;0;0;49275
2020-04-18;Zamora;Todos;Servicios de apoyo no sanitario;0;0;0;0;49275
2020-04-19;Ávila;Todos;Administrativo;24;16;11;5;5019
2020-04-19;Ávila;Todos;Celador;23;6;6;0;5019
2020-04-19;Ávila;Todos;Enfermero/a;206;80;66;14;5019
2020-04-19;Ávila;Todos;Médicos;179;70;46;24;5019
2020-04-19;Ávila;Todos;Otros sanitarios;9;5;5;0;5019
2020-04-19;Ávila;Todos;Personal en formación;10;4;2;2;5019
2020-04-19;Burgos;Todos;Administrativo;99;8;5;3;9059
2020-04-19;Burgos;Todos;Auxiliares sanitarios;151;38;21;17;9059
2020-04-19;Burgos;Todos;Celador;54;11;3;8;9059
2020-04-19;Burgos;Todos;Otros;7;1;0;1;9059
2020-04-19;Burgos;Todos;Otros sanitarios;14;0;0;0;9059
2020-04-19;Burgos;Todos;Servicios de apoyo no sanitario;11;2;1;1;9059
2020-04-19;Burgos;Todos;Técnicos sanitarios;24;4;1;3;9059
2020-04-19;León;Todos;Administrativo;100;14;6;8;24089
2020-04-19;León;Todos;Auxiliares sanitarios;245;49;30;19;24089
2020-04-19;León;Todos;Celador;90;14;10;4;24089
2020-04-19;León;Todos;Otros;4;0;0;0;24089
2020-04-19;León;Todos;Servicios de apoyo no sanitario;12;3;1;2;24089
2020-04-19;Palencia;Todos;Celador;31;11;9;2;34120
2020-04-19;Palencia;Todos;Enfermero/a;155;40;32;8;34120
2020-04-19;Palencia;Todos;Otros;2;0;0;0;34120
2020-04-19;Palencia;Todos;Técnicos sanitarios;6;3;3;0;34120
2020-04-19;Salamanca;Todos;Celador;62;23;18;5;37274
2020-04-19;Salamanca;Todos;Fisioterapeuta;7;4;2;2;37274
2020-04-19;Salamanca;Todos;Otros sanitarios;8;4;4;0;37274
2020-04-19;Salamanca;Todos;Personal en formación;64;23;11;12;37274
2020-04-19;Segovia;Todos;Enfermero/a;258;122;48;74;40004
2020-04-19;Segovia;Todos;Otros;0;0;0;0;40004
2020-04-19;Segovia;Todos;Personal en formación;24;10;4;6;40004
2020-04-19;Segovia;Todos;Técnicos sanitarios;28;13;6;7;40004
2020-04-19;Soria;Todos;Celador;17;10;3;7;42173
2020-04-19;Soria;Todos;Enfermero/a;127;66;29;37;42173
2020-04-19;Soria;Todos;Fisioterapeuta;4;1;0;1;42173
2020-04-19;Soria;Todos;Servicios de apoyo no sanitario;3;2;1;1;42173
2020-04-19;Soria;Todos;Técnicos sanitarios;13;8;4;4;42173
2020-04-19;Valladolid;Todos;Administrativo;186;24;13;11;47186
2020-04-19;Valladolid;Todos;Fisioterapeuta;34;3;2;1;47186
2020-04-19;Valladolid;Todos;Médicos;682;105;44;61;47186
2020-04-19;Valladolid;Todos;Otros;3;0;0;0;47186
2020-04-19;Valladolid;Todos;Técnicos sanitarios;59;9;5;4;47186
2020-04-19;Zamora;Todos;Celador;11;2;2;0;49275
2020-04-19;Zamora;Todos;Otros;0;0;0;0;49275
2020-04-19;Zamora;Todos;Servicios de apoyo no sanitario;1;0;0;0;49275
2020-04-20;Ávila;Todos;Administrativo;25;16;12;4;5019
2020-04-20;Ávila;Todos;Celador;25;6;6;0;5019
2020-04-20;Ávila;Todos;Enfermero/a;209;80;64;16;5019
2020-04-20;Ávila;Todos;Fisioterapeuta;6;0;0;0;5019
2020-04-20;Ávila;Todos;Personal en formación;10;4;2;2;5019
2020-04-20;Burgos;Todos;Administrativo;105;8;4;4;9059
2020-04-20;Burgos;Todos;Fisioterapeuta;18;1;0;1;9059
2020-04-20;Burgos;Todos;Otros;7;1;0;1;9059
2020-04-20;Burgos;Todos;Servicios de apoyo no sanitario;11;2;1;1;9059
2020-04-20;Burgos;Todos;Técnicos sanitarios;29;4;0;4;9059
2020-04-20;León;Todos;Administrativo;100;14;6;8;24089
2020-04-20;León;Todos;Auxiliares sanitarios;262;50;29;21;24089
2020-04-20;León;Todos;Enfermero/a;728;134;78;56;24089
2020-04-20;León;Todos;Médicos;541;89;40;49;24089
2020-04-20;León;Todos;Otros;4;0;0;0;24089
2020-04-20;León;Todos;Personal en formación;79;15;8;7;24089
2020-04-20;Palencia;Todos;Administrativo;53;4;4;0;34120
2020-04-20;Palencia;Todos;Enfermero/a;160;40;32;8;34120
2020-04-20;Palencia;Todos;Otros;2;0;0;0;34120
2020-04-20;Salamanca;Todos;Administrativo;52;19;9;10;37274
2020-04-20;Salamanca;Todos;Auxiliares sanitarios;201;74;44;30;37274
2020-04-20;Salamanca;Todos;Fisioterapeuta;7;4;2;2;37274
2020-04-20;Salamanca;Todos;Otros;4;2;2;0;37274
2020-04-20;Salamanca;Todos;Otros sanitarios;8;4;4;0;37274
2020-04-20;Salamanca;Todos;Servicios de apoyo no sanitario;31;13;6;7;37274
2020-04-20;Segovia;Todos;Auxiliares sanitarios;107;47;26;21;40004
2020-04-20;Segovia;Todos;Enfermero/a;265;124;40;84;40004
2020-04-20;Segovia;Todos;Médicos;190;79;21;58;40004
2020-04-20;Segovia;Todos;Otros;0;0;0;0;40004
2020-04-20;Segovia;Todos;Otros sanitarios;2;1;1;0;40004
2020-04-20;Soria;Todos;Enfermero/a;134;66;28;38;42173
2020-04-20;Soria;Todos;Fisioterapeuta;5;1;0;1;42173
2020-04-20;Soria;Todos;Médicos;115;55;25;30;42173
2020-04-20;Soria;Todos;Otros;0;0;0;0;42173
2020-04-20;Valladolid;Todos;Auxiliares sanitarios;227;48;37;11;47186
2020-04-20;Valladolid;Todos;Personal en formación;164;23;9;14;47186
2020-04-20;Zamora;Todos;Otros sanitarios;2;1;1;0;49275
2020-04-20;Zamora;Todos;Personal en formación;3;0;0;0;49275
2020-04-20;Zamora;Todos;Servicios de apoyo no sanitario;1;0;0;0;49275
2020-04-20;Zamora;Todos;Técnicos sanitarios;4;0;0;0;49275
2020-04-21;Ávila;Todos;Celador;26;6;5;1;5019
2020-04-21;Ávila;Todos;Otros;1;1;0;1;5019
2020-04-21;Ávila;Todos;Servicios de apoyo no sanitario;22;9;7;2;5019
2020-04-21;Ávila;Todos;Técnicos sanitarios;19;7;6;1;5019
2020-04-21;Burgos;Todos;Auxiliares sanitarios;161;39;22;17;9059
2020-04-21;Burgos;Todos;Fisioterapeuta;18;1;0;1;9059
2020-04-21;Burgos;Todos;Técnicos sanitarios;30;4;0;4;9059
2020-04-21;León;Todos;Celador;97;14;7;7;24089
2020-04-21;León;Todos;Médicos;566;93;39;54;24089
2020-04-21;León;Todos;Otros;4;0;0;0;24089
2020-04-21;León;Todos;Personal en formación;83;15;5;10;24089
2020-04-21;Palencia;Todos;Celador;32;12;10;2;34120
2020-04-21;Palencia;Todos;Enfermero/a;168;40;31;9;34120
2020-04-21;Palencia;Todos;Médicos;146;22;9;13;34120
2020-04-21;Palencia;Todos;Otros;2;0;0;0;34120
2020-04-21;Salamanca;Todos;Administrativo;53;20;10;10;37274
2020-04-21;Salamanca;Todos;Fisioterapeuta;7;4;1;3;37274
2020-04-21;Salamanca;Todos;Técnicos sanitarios;40;17;11;6;37274
2020-04-21;Segovia;Todos;Administrativo;47;17;5;12;40004
2020-04-21;Segovia;Todos;Auxiliares sanitarios;118;48;23;25;40004
2020-04-21;Segovia;Todos;Fisioterapeuta;4;1;0;1;40004
2020-04-21;Segovia;Todos;Personal en formación;26;11;4;7;40004
2020-04-21;Soria;Todos;Administrativo;24;12;6;6;42173
2020-04-21;Soria;Todos;Auxiliares sanitarios;63;23;10;13;42173
2020-04-21;Soria;Todos;Otros sanitarios;3;2;1;1;42173
2020-04-21;Soria;Todos;Técnicos sanitarios;13;8;4;4;42173
2020-04-21;Valladolid;Todos;Administrativo;221;26;14;12;47186
2020-04-21;Valladolid;Todos;Auxiliares sanitarios;247;51;36;15;47186
2020-04-21;Valladolid;Todos;Otros;3;0;0;0;47186
2020-04-22;Ávila;Todos;Enfermero/a;222;81;64;17;5019
2020-04-22;Ávila;Todos;Otros;1;1;0;1;5019
2020-04-22;Burgos;Todos;Celador;59;11;2;9;9059
2020-04-22;Burgos;Todos;Fisioterapeuta;19;2;1;1;9059
2020-04-22;Burgos;Todos;Médicos;412;59;23;36;9059
2020-04-22;Burgos;Todos;Personal en formación;41;4;0;4;9059
2020-04-22;León;Todos;Auxiliares sanitarios;316;55;31;24;24089
2020-04-22;León;Todos;Médicos;605;93;37;56;24089
2020-04-22;León;Todos;Otros;4;0;0;0;24089
2020-04-22;León;Todos;Servicios de apoyo no sanitario;17;3;1;2;24089
2020-04-22;Palencia;Todos;Enfermero/a;173;40;31;9;34120
2020-04-22;Palencia;Todos;Fisioterapeuta;6;1;1;0;34120
2020-04-22;Palencia;Todos;Médicos;152;22;9;13;34120
2020-04-22;Palencia;Todos;Otros;3;0;0;0;34120
2020-04-22;Palencia;Todos;Otros sanitarios;7;1;0;1;34120
2020-04-22;Salamanca;Todos;Auxiliares sanitarios;210;75;39;36;37274
2020-04-22;Salamanca;Todos;Enfermero/a;423;120;54;66;37274
2020-04-22;Salamanca;Todos;Otros sanitarios;8;4;3;1;37274
2020-04-22;Salamanca;Todos;Personal en formación;82;27;13;14;37274
2020-04-22;Salamanca;Todos;Técnicos sanitarios;40;17;10;7;37274
2020-04-22;Segovia;Todos;Administrativo;53;17;5;12;40004
2020-04-22;Segovia;Todos;Otros;0;0;0;0;40004
2020-04-22;Segovia;Todos;Otros sanitarios;2;1;1;0;40004
2020-04-22;Segovia;Todos;Servicios de apoyo no sanitario;19;9;3;6;40004
2020-04-22;Segovia;Todos;Técnicos sanitarios;31;13;6;7;40004
2020-04-22;Soria;Todos;Enfermero/a;153;69;29;40;42173
2020-04-22;Soria;Todos;Servicios de apoyo no sanitario;6;2;1;1;42173
2020-04-22;Soria;Todos;Técnicos sanitarios;15;8;4;4;42173
2020-04-22;Valladolid;Todos;Auxiliares sanitarios;252;51;35;16;47186
2020-04-22;Valladolid;Todos;Celador;99;18;13;5;47186
2020-04-22;Valladolid;Todos;Enfermero/a;839;144;86;58;47186
2020-04-22;Valladolid;Todos;Otros;4;0;0;0;47186
2020-04-22;Valladolid;Todos;Otros sanitarios;20;4;1;3;47186
2020-04-22;Valladolid;Todos;Personal en formación;186;25;8;17;47186
2020-04-22;Zamora;Todos;Auxiliares sanitarios;40;5;4;1;49275
2020-04-22;Zamora;Todos;Celador;21;2;1;1;49275
2020-04-22;Zamora;Todos;Fisioterapeuta;5;1;1;0;49275
2020-04-22;Zamora;Todos;Otros sanitarios;3;1;0;1;49275
2020-04-22;Zamora;Todos;Servicios de apoyo no sanitario;1;0;0;0;49275
2020-04-23;Ávila;Todos;Otros;1;1;0;1;5019
2020-04-23;Ávila;Todos;Personal en formación;10;4;2;2;5019
2020-04-23;Burgos;Todos;Auxiliares sanitarios;195;39;18;21;9059
2020-04-23;Burgos;Todos;Enfermero/a;522;76;31;45;9059
2020-04-23;Burgos;Todos;Fisioterapeuta;19;2;1;1;9059
2020-04-23;Burgos;Todos;Personal en formación;41;4;0;4;9059
2020-04-23;León;Todos;Enfermero/a;828;142;82;60;24089
2020-04-23;León;Todos;Otros;6;0;0;0;24089
2020-04-23;León;Todos;Otros sanitarios;24;3;1;2;24089
2020-04-23;León;Todos;Personal en formación;104;16;6;10;24089
2020-04-23;León;Todos;Técnicos sanitarios;49;7;3;4;24089
2020-04-23;Palencia;Todos;Celador;33;12;9;3;34120
2020-04-23;Palencia;Todos;Otros sanitarios;7;1;0;1;34120
2020-04-23;Salamanca;Todos;Auxiliares sanitarios;212;76;40;36;37274
2020-04-23;Salamanca;Todos;Enfermero/a;425;121;57;64;37274
2020-04-23;Salamanca;Todos;Servicios de apoyo no sanitario;33;14;7;7;37274
2020-04-23;Salamanca;Todos;Técnicos sanitarios;40;17;9;8;37274
2020-04-23;Segovia;Todos;Administrativo;53;17;5;12;40004
2020-04-23;Soria;Todos;Auxiliares sanitarios;78;24;11;13;42173
2020-04-23;Soria;Todos;Enfermero/a;153;69;29;40;42173
2020-04-23;Valladolid;Todos;Fisioterapeuta;39;4;3;1;47186
2020-04-23;Valladolid;Todos;Servicios de apoyo no sanitario;43;8;4;4;47186
2020-04-23;Valladolid;Todos;Técnicos sanitarios;70;10;5;5;47186
2020-04-23;Zamora;Todos;Administrativo;27;6;4;2;49275
2020-04-23;Zamora;Todos;Enfermero/a;134;22;14;8;49275
2020-04-23;Zamora;Todos;Fisioterapeuta;5;1;1;0;49275
2020-04-23;Zamora;Todos;Otros;0;0;0;0;49275
2020-04-23;Zamora;Todos;Técnicos sanitarios;5;0;0;0;49275
2020-04-24;Ávila;Todos;Médicos;201;69;43;26;5019
2020-04-24;Ávila;Todos;Otros;1;1;0;1;5019
2020-04-24;Ávila;Todos;Otros sanitarios;10;5;5;0;5019
2020-04-24;Ávila;Todos;Personal en formación;13;4;2;2;5019
2020-04-24;Burgos;Todos;Administrativo;108;9;4;5;9059
2020-04-24;Burgos;Todos;Auxiliares sanitarios;228;43;21;22;9059
2020-04-24;Burgos;Todos;Enfermero/a;558;75;28;47;9059
2020-04-24;Burgos;Todos;Otros;8;1;0;1;9059
2020-04-24;Burgos;Todos;Otros sanitarios;18;0;0;0;9059
2020-04-24;Palencia;Todos;Auxiliares sanitarios;61;15;10;5;34120
2020-04-24;Palencia;Todos;Celador;34;12;8;4;34120
2020-04-24;Palencia;Todos;Otros sanitarios;7;1;0;1;34120
2020-04-24;Palencia;Todos;Técnicos sanitarios;9;3;3;0;34120
2020-04-24;Salamanca;Todos;Enfermero/a;431;121;49;72;37274
2020-04-24;Salamanca;Todos;Otros sanitarios;8;4;3;1;37274
2020-04-24;Salamanca;Todos;Personal en formación;85;28;14;14;37274
2020-04-24;Salamanca;Todos;Servicios de apoyo no sanitario;34;14;6;8;37274
2020-04-24;Segovia;Todos;Auxiliares sanitarios;138;48;19;29;40004
2020-04-24;Segovia;Todos;Celador;54;21;10;11;40004
2020-04-24;Segovia;Todos;Enfermero/a;294;125;25;100;40004
2020-04-24;Segovia;Todos;Fisioterapeuta;4;1;0;1;40004
2020-04-24;Segovia;Todos;Médicos;203;78;15;63;40004
2020-04-24;Segovia;Todos;Servicios de apoyo no sanitario;19;9;2;7;40004
2020-04-24;Segovia;Todos;Técnicos sanitarios;32;13;6;7;40004
2020-04-24;Soria;Todos;Fisioterapeuta;6;1;0;1;42173
2020-04-24;Soria;Todos;Otros;0;0;0;0;42173
2020-04-24;Soria;Todos;Otros sanitarios;5;2;1;1;42173
2020-04-24;Valladolid;Todos;Auxiliares sanitarios;268;52;35;17;47186
2020-04-24;Valladolid;Todos;Enfermero/a;870;145;85;60;47186
2020-04-24;Valladolid;Todos;Médicos;817;113;39;74;47186
2020-04-24;Valladolid;Todos;Técnicos sanitarios;71;10;5;5;47186
2020-04-24;Zamora;Todos;Administrativo;31;5;3;2;49275
2020-04-24;Zamora;Todos;Otros;0;0;0;0;49275
2020-04-24;Zamora;Todos;Otros sanitarios;3;1;0;1;49275
2020-04-24;Zamora;Todos;Personal en formación;11;1;1;0;49275
2020-04-25;Ávila;Todos;Auxiliares sanitarios;158;40;32;8;5019
2020-04-25;Ávila;Todos;Celador;57;9;8;1;5019
2020-04-25;Burgos;Todos;Fisioterapeuta;19;2;1;1;9059
2020-04-25;Burgos;Todos;Otros sanitarios;18;0;0;0;9059
2020-04-25;Burgos;Todos;Personal en formación;42;4;0;4;9059
2020-04-25;Burgos;Todos;Servicios de apoyo no sanitario;19;3;2;1;9059
2020-04-25;León;Todos;Administrativo;132;14;5;9;24089
2020-04-25;León;Todos;Médicos;636;91;26;65;24089
2020-04-25;León;Todos;Personal en formación;114;16;5;11;24089
2020-04-25;León;Todos;Servicios de apoyo no sanitario;17;3;1;2;24089
2020-04-25;Palencia;Todos;Celador;34;12;8;4;34120
2020-04-25;Palencia;Todos;Fisioterapeuta;6;1;1;0;34120
2020-04-25;Palencia;Todos;Otros;3;0;0;0;34120
2020-04-25;Palencia;Todos;Técnicos sanitarios;9;3;3;0;34120
2020-04-25;Salamanca;Todos;Auxiliares sanitarios;223;80;39;41;37274
2020-04-25;Salamanca;Todos;Fisioterapeuta;6;4;1;3;37274
2020-04-25;Salamanca;Todos;Técnicos sanitarios;40;17;7;10;37274
2020-04-25;Segovia;Todos;Médicos;203;78;15;63;40004
2020-04-25;Segovia;Todos;Otros;0;0;0;0;40004
2020-04-25;Segovia;Todos;Servicios de apoyo no sanitario;20;9;2;7;40004
2020-04-25;Valladolid;Todos;Administrativo;234;26;11;15;47186
2020-04-25;Valladolid;Todos;Celador;106;19;13;6;47186
2020-04-25;Valladolid;Todos;Otros sanitarios;21;4;1;3;47186
2020-04-25;Zamora;Todos;Administrativo;31;5;3;2;49275
2020-04-25;Zamora;Todos;Enfermero/a;145;21;14;7;49275
2020-04-26;Ávila;Todos;Administrativo;27;16;12;4;5019
2020-04-26;Ávila;Todos;Auxiliares sanitarios;178;41;33;8;5019
2020-04-26;Ávila;Todos;Celador;74;10;9;1;5019
2020-04-26;Ávila;Todos;Enfermero/a;316;84;67;17;5019
2020-04-26;Ávila;Todos;Servicios de apoyo no sanitario;22;9;8;1;5019
2020-04-26;Ávila;Todos;Técnicos sanitarios;19;7;6;1;5019
2020-04-26;Burgos;Todos;Fisioterapeuta;19;2;1;1;9059
2020-04-26;Burgos;Todos;Otros;8;2;1;1;9059
2020-04-26;Burgos;Todos;Otros sanitarios;18;0;0;0;9059
2020-04-26;León;Todos;Administrativo;132;14;5;9;24089
2020-04-26;León;Todos;Enfermero/a;849;143;71;72;24089
2020-04-26;León;Todos;Otros;6;0;0;0;24089
2020-04-26;León;Todos;Otros sanitarios;24;3;0;3;24089
2020-04-26;Palencia;Todos;Administrativo;59;5;3;2;34120
2020-04-26;Salamanca;Todos;Administrativo;57;21;10;11;37274
2020-04-26;Salamanca;Todos;Médicos;366;127;41;86;37274
2020-04-26;Salamanca;Todos;Otros;4;3;3;0;37274
2020-04-26;Segovia;Todos;Auxiliares sanitarios;137;47;18;29;40004
2020-04-26;Segovia;Todos;Fisioterapeuta;4;1;0;1;40004
2020-04-26;Segovia;Todos;Médicos;203;78;15;63;40004
2020-04-26;Segovia;Todos;Técnicos sanitarios;32;13;6;7;40004
2020-04-26;Soria;Todos;Otros;0;0;0;0;42173
2020-04-26;Soria;Todos;Personal en formación;25;2;1;1;42173
2020-04-26;Soria;Todos;Servicios de apoyo no sanitario;16;4;2;2;42173
2020-04-26;Soria;Todos;Técnicos sanitarios;20;8;3;5;42173
2020-04-26;Valladolid;Todos;Auxiliares sanitarios;290;53;32;21;47186
2020-04-26;Valladolid;Todos;Enfermero/a;905;150;77;73;47186
2020-04-26;Valladolid;Todos;Otros;4;0;0;0;47186
2020-04-26;Valladolid;Todos;Otros sanitarios;21;4;0;4;47186
2020-04-26;Valladolid;Todos;Técnicos sanitarios;81;10;5;5;47186
2020-04-26;Zamora;Todos;Administrativo;31;5;3;2;49275
2020-04-26;Zamora;Todos;Fisioterapeuta;7;1;1;0;49275
2020-04-26;Zamora;Todos;Personal en formación;11;1;1;0;49275
2020-04-27;Ávila;Todos;Administrativo;27;16;12;4;5019
2020-04-27;Ávila;Todos;Auxiliares sanitarios;183;42;33;9;5019
2020-04-27;Ávila;Todos;Celador;88;11;10;1;5019
2020-04-27;Ávila;Todos;Enfermero/a;326;86;67;19;5019
2020-04-27;Ávila;Todos;Médicos;229;73;45;28;5019
2020-04-27;Ávila;Todos;Otros;1;1;0;1;5019
2020-04-27;Ávila;Todos;Servicios de apoyo no sanitario;22;9;8;1;5019
2020-04-27;Ávila;Todos;Técnicos sanitarios;19;7;6;1;5019
2020-04-27;Burgos;Todos;Auxiliares sanitarios;269;46;23;23;9059
2020-04-27;Burgos;Todos;Enfermero/a;611;78;29;49;9059
2020-04-27;Burgos;Todos;Otros;9;2;1;1;9059
2020-04-27;León;Todos;Administrativo;140;14;5;9;24089
2020-04-27;León;Todos;Médicos;660;92;25;67;24089
2020-04-27;León;Todos;Otros sanitarios;26;3;0;3;24089
2020-04-27;León;Todos;Personal en formación;121;16;5;11;24089
2020-04-27;León;Todos;Servicios de apoyo no sanitario;17;3;1;2;24089
2020-04-27;Palencia;Todos;Celador;34;12;7;5;34120
2020-04-27;Palencia;Todos;Personal en formación;18;6;1;5;34120
2020-04-27;Salamanca;Todos;Celador;68;25;11;14;37274
2020-04-27;Salamanca;Todos;Otros;4;3;3;0;37274
2020-04-27;Salamanca;Todos;Personal en formación;87;29;15;14;37274
2020-04-27;Salamanca;Todos;Servicios de apoyo no sanitario;34;14;4;10;37274
2020-04-27;Segovia;Todos;Auxiliares sanitarios;142;49;13;36;40004
2020-04-27;Segovia;Todos;Enfermero/a;302;125;21;104;40004
2020-04-27;Segovia;Todos;Médicos;207;78;13;65;40004
2020-04-27;Segovia;Todos;Otros;0;0;0;0;40004
2020-04-27;Segovia;Todos;Personal en formación;29;11;2;9;40004
2020-04-27;Segovia;Todos;Técnicos sanitarios;34;13;5;8;40004
2020-04-27;Soria;Todos;Fisioterapeuta;7;1;0;1;42173
2020-04-27;Soria;Todos;Médicos;186;61;21;40;42173
2020-04-27;Soria;Todos;Otros;0;0;0;0;42173
2020-04-27;Soria;Todos;Técnicos sanitarios;21;8;3;5;42173
2020-04-27;Valladolid;Todos;Auxiliares sanitarios;303;54;30;24;47186
2020-04-27;Valladolid;Todos;Celador;114;21;12;9;47186
2020-04-27;Zamora;Todos;Fisioterapeuta;8;1;1;0;49275
2020-04-27;Zamora;Todos;Otros sanitarios;3;1;0;1;49275
2020-04-28;Ávila;Todos;Auxiliares sanitarios;189;43;31;12;5019
2020-04-28;Burgos;Todos;Auxiliares sanitarios;295;47;24;23;9059
2020-04-28;Burgos;Todos;Enfermero/a;662;82;33;49;9059
2020-04-28;Burgos;Todos;Fisioterapeuta;20;2;1;1;9059
2020-04-28;Burgos;Todos;Otros;10;2;1;1;9059
2020-04-28;Burgos;Todos;Servicios de apoyo no sanitario;20;3;2;1;9059
2020-04-28;Burgos;Todos;Técnicos sanitarios;52;4;0;4;9059
2020-04-28;León;Todos;Administrativo;148;14;5;9;24089
2020-04-28;León;Todos;Auxiliares sanitarios;357;60;28;32;24089
2020-04-28;León;Todos;Otros sanitarios;26;3;0;3;24089
2020-04-28;León;Todos;Servicios de apoyo no sanitario;18;3;1;2;24089
2020-04-28;Palencia;Todos;Celador;34;12;7;5;34120
2020-04-28;Salamanca;Todos;Administrativo;60;23;12;11;37274
2020-04-28;Salamanca;Todos;Servicios de apoyo no sanitario;35;14;4;10;37274
2020-04-28;Salamanca;Todos;Técnicos sanitarios;39;16;5;11;37274
2020-04-28;Segovia;Todos;Administrativo;68;18;6;12;40004
2020-04-28;Segovia;Todos;Fisioterapeuta;6;1;0;1;40004
2020-04-28;Soria;Todos;Administrativo;59;18;5;13;42173
2020-04-28;Soria;Todos;Auxiliares sanitarios;117;26;10;16;42173
2020-04-28;Soria;Todos;Fisioterapeuta;8;1;0;1;42173
2020-04-28;Soria;Todos;Técnicos sanitarios;27;8;4;4;42173
2020-04-28;Valladolid;Todos;Celador;114;22;14;8;47186
2020-04-28;Valladolid;Todos;Enfermero/a;934;153;67;86;47186
2020-04-28;Valladolid;Todos;Fisioterapeuta;39;4;2;2;47186
2020-04-28;Valladolid;Todos;Técnicos sanitarios;89;10;5;5;47186
2020-04-28;Zamora;Todos;Administrativo;36;5;3;2;49275
2020-04-28;Zamora;Todos;Fisioterapeuta;10;1;1;0;49275
2020-04-28;Zamora;Todos;Personal en formación;21;1;1;0;49275
2020-04-28;Zamora;Todos;Servicios de apoyo no sanitario;1;0;0;0;49275
2020-04-29;Ávila;Todos;Administrativo;49;18;14;4;5019
2020-04-29;Ávila;Todos;Celador;100;11;10;1;5019
2020-04-29;Ávila;Todos;Otros;1;1;0;1;5019
2020-04-29;Ávila;Todos;Otros sanitarios;15;6;5;1;5019
2020-04-29;Ávila;Todos;Servicios de apoyo no sanitario;23;9;8;1;5019
2020-04-29;Ávila;Todos;Técnicos sanitarios;29;7;6;1;5019
2020-04-29;Burgos;Todos;Fisioterapeuta;20;2;1;1;9059
2020-04-29;Burgos;Todos;Médicos;488;61;21;40;9059
2020-04-29;Burgos;Todos;Otros;10;2;1;1;9059
2020-04-29;Burgos;Todos;Servicios de apoyo no sanitario;20;3;2;1;9059
2020-04-29;León;Todos;Fisioterapeuta;21;2;0;2;24089
2020-04-29;León;Todos;Otros;6;0;0;0;24089
2020-04-29;León;Todos;Servicios de apoyo no sanitario;19;3;1;2;24089
2020-04-29;Palencia;Todos;Médicos;168;29;9;20;34120
2020-04-29;Palencia;Todos;Servicios de apoyo no sanitario;14;3;1;2;34120
2020-04-29;Palencia;Todos;Técnicos sanitarios;9;3;2;1;34120
2020-04-29;Salamanca;Todos;Administrativo;103;24;12;12;37274
2020-04-29;Salamanca;Todos;Personal en formación;99;29;14;15;37274
2020-04-29;Segovia;Todos;Auxiliares sanitarios;182;55;15;40;40004
2020-04-29;Segovia;Todos;Fisioterapeuta;7;2;1;1;40004
2020-04-29;Segovia;Todos;Médicos;272;86;19;67;40004
2020-04-29;Segovia;Todos;Otros;0;0;0;0;40004
2020-04-29;Segovia;Todos;Servicios de apoyo no sanitario;22;9;0;9;40004
2020-04-29;Segovia;Todos;Técnicos sanitarios;37;13;3;10;40004
2020-04-29;Soria;Todos;Enfermero/a;258;77;29;48;42173
2020-04-29;Soria;Todos;Médicos;207;63;21;42;42173
2020-04-29;Soria;Todos;Otros;0;0;0;0;42173
2020-04-29;Soria;Todos;Otros sanitarios;8;3;2;1;42173
2020-04-29;Soria;Todos;Técnicos sanitarios;29;8;4;4;42173
2020-04-29;Valladolid;Todos;Administrativo;242;26;9;17;47186
2020-04-29;Valladolid;Todos;Auxiliares sanitarios;325;57;27;30;47186
2020-04-29;Valladolid;Todos;Enfermero/a;965;155;57;98;47186
2020-04-29;Valladolid;Todos;Personal en formación;204;26;6;20;47186
2020-04-29;Zamora;Todos;Auxiliares sanitarios;121;6;5;1;49275
2020-04-29;Zamora;Todos;Fisioterapeuta;10;1;1;0;49275
2020-04-29;Zamora;Todos;Otros;0;0;0;0;49275
2020-04-29;Zamora;Todos;Otros sanitarios;4;1;0;1;49275
2020-04-29;Zamora;Todos;Técnicos sanitarios;6;0;0;0;49275
2020-04-30;Ávila;Todos;Fisioterapeuta;14;0;0;0;5019
2020-04-30;Ávila;Todos;Servicios de apoyo no sanitario;24;9;8;1;5019
2020-04-30;Burgos;Todos;Administrativo;132;9;3;6;9059
2020-04-30;León;Todos;Administrativo;154;14;5;9;24089
2020-04-30;León;Todos;Personal en formación;137;17;3;14;24089
2020-04-30;Palencia;Todos;Enfermero/a;195;43;18;25;34120
2020-04-30;Salamanca;Todos;Auxiliares sanitarios;254;85;29;56;37274
2020-04-30;Salamanca;Todos;Enfermero/a;676;140;48;92;37274
2020-04-30;Salamanca;Todos;Otros;4;3;3;0;37274
2020-04-30;Salamanca;Todos;Otros sanitarios;15;4;3;1;37274
2020-04-30;Salamanca;Todos;Técnicos sanitarios;44;16;5;11;37274
2020-04-30;Segovia;Todos;Personal en formación;48;17;5;12;40004
2020-04-30;Segovia;Todos;Técnicos sanitarios;38;13;2;11;40004
2020-04-30;Soria;Todos;Auxiliares sanitarios;136;29;11;18;42173
2020-04-30;Soria;Todos;Médicos;222;64;19;45;42173
2020-04-30;Soria;Todos;Otros sanitarios;8;3;2;1;42173
2020-04-30;Soria;Todos;Servicios de apoyo no sanitario;23;4;1;3;42173
2020-04-30;Zamora;Todos;Fisioterapeuta;13;1;1;0;49275
2020-04-30;Zamora;Todos;Personal en formación;21;1;1;0;49275
2020-04-30;Zamora;Todos;Servicios de apoyo no sanitario;2;0;0;0;49275
2020-05-01;Ávila;Todos;Auxiliares sanitarios;202;45;31;14;5019
2020-05-01;Ávila;Todos;Celador;106;13;10;3;5019
2020-05-01;Ávila;Todos;Servicios de apoyo no sanitario;25;9;8;1;5019
2020-05-01;Burgos;Todos;Fisioterapeuta;21;2;1;1;9059
2020-05-01;Burgos;Todos;Otros sanitarios;19;0;0;0;9059
2020-05-01;Burgos;Todos;Personal en formación;84;8;1;7;9059
2020-05-01;Burgos;Todos;Servicios de apoyo no sanitario;27;3;2;1;9059
2020-05-01;Burgos;Todos;Técnicos sanitarios;62;5;1;4;9059
2020-05-01;León;Todos;Celador;235;20;9;11;24089
2020-05-01;León;Todos;Otros;6;0;0;0;24089
2020-05-01;León;Todos;Personal en formación;140;17;3;14;24089
2020-05-01;Palencia;Todos;Administrativo;60;5;1;4;34120
2020-05-01;Palencia;Todos;Auxiliares sanitarios;77;18;8;10;34120
2020-05-01;Palencia;Todos;Servicios de apoyo no sanitario;14;3;1;2;34120
2020-05-01;Salamanca;Todos;Auxiliares sanitarios;255;85;29;56;37274
2020-05-01;Salamanca;Todos;Fisioterapeuta;19;5;2;3;37274
2020-05-01;Salamanca;Todos;Otros;4;3;3;0;37274
2020-05-01;Salamanca;Todos;Otros sanitarios;15;4;3;1;37274
2020-05-01;Salamanca;Todos;Servicios de apoyo no sanitario;37;14;4;10;37274
2020-05-01;Segovia;Todos;Administrativo;80;19;4;15;40004
2020-05-01;Segovia;Todos;Auxiliares sanitarios;200;57;14;43;40004
2020-05-01;Segovia;Todos;Celador;105;29;10;19;40004
2020-05-01;Segovia;Todos;Enfermero/a;438;149;38;111;40004
2020-05-01;Segovia;Todos;Fisioterapeuta;8;2;1;1;40004
2020-05-01;Segovia;Todos;Médicos;297;90;22;68;40004
2020-05-01;Segovia;Todos;Otros;0;0;0;0;40004
2020-05-01;Soria;Todos;Auxiliares sanitarios;136;29;11;18;42173
2020-05-01;Soria;Todos;Enfermero/a;290;83;25;58;42173
2020-05-01;Soria;Todos;Médicos;222;64;18;46;42173
2020-05-01;Valladolid;Todos;Auxiliares sanitarios;339;56;21;35;47186
2020-05-01;Valladolid;Todos;Celador;119;23;9;14;47186
2020-05-01;Valladolid;Todos;Médicos;857;115;24;91;47186
2020-05-01;Valladolid;Todos;Personal en formación;202;25;5;20;47186
2020-05-01;Zamora;Todos;Auxiliares sanitarios;126;6;4;2;49275
2020-05-01;Zamora;Todos;Enfermero/a;290;26;14;12;49275
2020-05-01;Zamora;Todos;Médicos;247;20;8;12;49275
2020-05-02;Ávila;Todos;Administrativo;56;18;14;4;5019
2020-05-02;Ávila;Todos;Celador;108;13;10;3;5019
2020-05-02;Ávila;Todos;Enfermero/a;464;87;62;25;5019
2020-05-02;Ávila;Todos;Servicios de apoyo no sanitario;25;9;8;1;5019
2020-05-02;Burgos;Todos;Fisioterapeuta;21;2;1;1;9059
2020-05-02;Burgos;Todos;Otros;11;2;1;1;9059
2020-05-02;Burgos;Todos;Otros sanitarios;19;0;0;0;9059
2020-05-02;Burgos;Todos;Personal en formación;84;8;1;7;9059
2020-05-02;León;Todos;Administrativo;154;14;5;9;24089
2020-05-02;León;Todos;Celador;235;20;9;11;24089
2020-05-02;León;Todos;Técnicos sanitarios;65;8;3;5;24089
2020-05-02;Palencia;Todos;Celador;34;12;2;10;34120
2020-05-02;Palencia;Todos;Enfermero/a;199;43;15;28;34120
2020-05-02;Palencia;Todos;Médicos;174;29;5;24;34120
2020-05-02;Palencia;Todos;Otros sanitarios;7;1;0;1;34120
2020-05-02;Salamanca;Todos;Celador;89;25;6;19;37274
2020-05-02;Salamanca;Todos;Enfermero/a;693;141;46;95;37274
2020-05-02;Salamanca;Todos;Fisioterapeuta;20;6;3;3;37274
2020-05-02;Salamanca;Todos;Médicos;601;141;41;100;37274
2020-05-02;Salamanca;Todos;Personal en formación;113;33;13;20;37274
2020-05-02;Segovia;Todos;Administrativo;80;19;4;15;40004
2020-05-02;Segovia;Todos;Auxiliares sanitarios;201;58;14;44;40004
2020-05-02;Segovia;Todos;Otros;0;0;0;0;40004
2020-05-02;Segovia;Todos;Otros sanitarios;7;4;2;2;40004
2020-05-02;Soria;Todos;Administrativo;72;18;5;13;42173
2020-05-02;Soria;Todos;Celador;84;14;2;12;42173
2020-05-02;Soria;Todos;Fisioterapeuta;8;1;0;1;42173
2020-05-02;Soria;Todos;Otros;0;0;0;0;42173
2020-05-02;Soria;Todos;Otros sanitarios;8;3;2;1;42173
2020-05-02;Valladolid;Todos;Administrativo;246;26;8;18;47186
2020-05-02;Valladolid;Todos;Celador;119;23;9;14;47186
2020-05-02;Valladolid;Todos;Fisioterapeuta;40;4;2;2;47186
2020-05-02;Zamora;Todos;Otros;0;0;0;0;49275
2020-05-02;Zamora;Todos;Otros sanitarios;4;1;0;1;49275
2020-05-02;Zamora;Todos;Técnicos sanitarios;7;0;0;0;49275
2020-05-03;Ávila;Todos;Enfermero/a;481;87;62;25;5019
2020-05-03;Ávila;Todos;Médicos;356;80;44;36;5019
2020-05-03;Ávila;Todos;Otros sanitarios;15;6;5;1;5019
2020-05-03;Ávila;Todos;Personal en formación;36;4;1;3;5019
2020-05-03;Burgos;Todos;Administrativo;136;9;3;6;9059
2020-05-03;Burgos;Todos;Otros;11;2;1;1;9059
2020-05-03;Burgos;Todos;Personal en formación;84;8;1;7;9059
2020-05-03;León;Todos;Auxiliares sanitarios;444;63;29;34;24089
2020-05-03;León;Todos;Celador;235;20;9;11;24089
2020-05-03;León;Todos;Servicios de apoyo no sanitario;21;3;1;2;24089
2020-05-03;Palencia;Todos;Auxiliares sanitarios;79;18;7;11;34120
2020-05-03;Palencia;Todos;Celador;34;12;2;10;34120
2020-05-03;Palencia;Todos;Enfermero/a;201;44;17;27;34120
2020-05-03;Palencia;Todos;Fisioterapeuta;6;1;1;0;34120
2020-05-03;Palencia;Todos;Médicos;176;29;5;24;34120
2020-05-03;Palencia;Todos;Servicios de apoyo no sanitario;14;3;1;2;34120
2020-05-03;Salamanca;Todos;Celador;89;25;6;19;37274
2020-05-03;Segovia;Todos;Fisioterapeuta;8;2;1;1;40004
2020-05-03;Segovia;Todos;Otros;0;0;0;0;40004
2020-05-03;Segovia;Todos;Técnicos sanitarios;39;13;2;11;40004
2020-05-03;Soria;Todos;Administrativo;72;18;5;13;42173
2020-05-03;Soria;Todos;Otros;0;0;0;0;42173
2020-05-03;Soria;Todos;Otros sanitarios;8;3;2;1;42173
2020-05-03;Soria;Todos;Personal en formación;27;2;1;1;42173
2020-05-03;Soria;Todos;Servicios de apoyo no sanitario;23;4;1;3;42173
2020-05-03;Valladolid;Todos;Enfermero/a;992;156;51;105;47186
2020-05-03;Valladolid;Todos;Otros;5;0;0;0;47186
2020-05-03;Valladolid;Todos;Otros sanitarios;23;4;0;4;47186
2020-05-03;Zamora;Todos;Auxiliares sanitarios;126;6;4;2;49275
2020-05-03;Zamora;Todos;Fisioterapeuta;13;1;1;0;49275
2020-05-03;Zamora;Todos;Servicios de apoyo no sanitario;2;0;0;0;49275
2020-05-03;Zamora;Todos;Técnicos sanitarios;7;0;0;0;49275
2020-05-04;Ávila;Todos;Otros;0;0;0;0;5019
2020-05-04;Ávila;Todos;Personal en formación;36;4;1;3;5019
2020-05-04;Ávila;Todos;Servicios de apoyo no sanitario;26;10;9;1;5019
2020-05-04;Burgos;Todos;Enfermero/a;837;89;31;58;9059
2020-05-04;Burgos;Todos;Médicos;550;65;19;46;9059
2020-05-04;Burgos;Todos;Personal en formación;89;8;1;7;9059
2020-05-04;León;Todos;Enfermero/a;1115;149;47;102;24089
2020-05-04;León;Todos;Médicos;762;99;19;80;24089
2020-05-04;León;Todos;Otros;6;0;0;0;24089
2020-05-04;Palencia;Todos;Administrativo;61;5;1;4;34120
2020-05-04;Palencia;Todos;Auxiliares sanitarios;82;18;7;11;34120
2020-05-04;Salamanca;Todos;Administrativo;151;25;13;12;37274
2020-05-04;Salamanca;Todos;Otros;4;3;2;1;37274
2020-05-04;Salamanca;Todos;Técnicos sanitarios;48;16;4;12;37274
2020-05-04;Segovia;Todos;Auxiliares sanitarios;231;66;22;44;40004
2020-05-04;Segovia;Todos;Fisioterapeuta;8;2;1;1;40004
2020-05-04;Soria;Todos;Auxiliares sanitarios;154;34;14;20;42173
2020-05-04;Soria;Todos;Celador;85;14;1;13;42173
2020-05-04;Soria;Todos;Enfermero/a;319;87;25;62;42173
2020-05-04;Soria;Todos;Otros;0;0;0;0;42173
2020-05-04;Soria;Todos;Otros sanitarios;8;3;2;1;42173
2020-05-04;Soria;Todos;Personal en formación;27;2;1;1;42173
2020-05-04;Soria;Todos;Servicios de apoyo no sanitario;26;5;1;4;42173
2020-05-04;Soria;Todos;Técnicos sanitarios;30;8;2;6;42173
2020-05-04;Valladolid;Todos;Administrativo;247;25;9;16;47186
2020-05-04;Valladolid;Todos;Auxiliares sanitarios;328;61;23;38;47186
2020-05-04;Valladolid;Todos;Enfermero/a;995;152;43;109;47186
2020-05-04;Valladolid;Todos;Fisioterapeuta;42;4;1;3;47186
2020-05-04;Valladolid;Todos;Otros sanitarios;23;4;1;3;47186
2020-05-04;Zamora;Todos;Administrativo;46;4;1;3;49275
2020-05-04;Zamora;Todos;Auxiliares sanitarios;124;7;5;2;49275
2020-05-04;Zamora;Todos;Otros;0;0;0;0;49275
2020-05-04;Zamora;Todos;Personal en formación;22;1;1;0;49275
2020-05-04;Zamora;Todos;Servicios de apoyo no sanitario;1;0;0;0;49275
2020-05-05;Ávila;Todos;Auxiliares sanitarios;236;48;32;16;5019
2020-05-05;Ávila;Todos;Médicos;365;81;44;37;5019
2020-05-05;Ávila;Todos;Técnicos sanitarios;45;9;5;4;5019
2020-05-05;Burgos;Todos;Médicos;569;66;21;45;9059
2020-05-05;Burgos;Todos;Otros sanitarios;19;0;0;0;9059
2020-05-05;León;Todos;Auxiliares sanitarios;456;65;25;40;24089
2020-05-05;León;Todos;Fisioterapeuta;30;2;1;1;24089
2020-05-05;León;Todos;Personal en formación;152;17;3;14;24089
2020-05-05;Palencia;Todos;Auxiliares sanitarios;92;18;7;11;34120
2020-05-05;Palencia;Todos;Fisioterapeuta;8;2;2;0;34120
2020-05-05;Palencia;Todos;Médicos;179;29;5;24;34120
2020-05-05;Palencia;Todos;Otros;5;1;1;0;34120
2020-05-05;Salamanca;Todos;Administrativo;165;26;12;14;37274
2020-05-05;Salamanca;Todos;Otros sanitarios;17;4;3;1;37274
2020-05-05;Salamanca;Todos;Personal en formación;123;32;13;19;37274
2020-05-05;Salamanca;Todos;Técnicos sanitarios;50;16;4;12;37274
2020-05-05;Segovia;Todos;Administrativo;107;23;11;12;40004
2020-05-05;Segovia;Todos;Médicos;342;98;27;71;40004
2020-05-05;Segovia;Todos;Otros;0;0;0;0;40004
2020-05-05;Soria;Todos;Administrativo;91;20;6;14;42173
2020-05-05;Soria;Todos;Otros;0;0;0;0;42173
2020-05-05;Soria;Todos;Técnicos sanitarios;41;10;2;8;42173
2020-05-05;Valladolid;Todos;Auxiliares sanitarios;351;62;25;37;47186
2020-05-05;Valladolid;Todos;Personal en formación;214;26;6;20;47186
2020-05-05;Zamora;Todos;Auxiliares sanitarios;126;9;5;4;49275
2020-05-05;Zamora;Todos;Enfermero/a;323;31;15;16;49275
2020-05-05;Zamora;Todos;Personal en formación;22;1;1;0;49275
2020-05-06;Ávila;Todos;Auxiliares sanitarios;237;48;33;15;5019
2020-05-06;Ávila;Todos;Celador;112;13;10;3;5019
2020-05-06;Ávila;Todos;Enfermero/a;512;88;57;31;5019
2020-05-06;Ávila;Todos;Fisioterapeuta;14;0;0;0;5019
2020-05-06;Ávila;Todos;Otros;0;0;0;0;5019
2020-05-06;Ávila;Todos;Servicios de apoyo no sanitario;28;10;8;2;5019
2020-05-06;Burgos;Todos;Celador;133;16;3;13;9059
2020-05-06;Burgos;Todos;Fisioterapeuta;21;2;1;1;9059
2020-05-06;Burgos;Todos;Médicos;584;70;19;51;9059
2020-05-06;Burgos;Todos;Otros sanitarios;20;0;0;0;9059
2020-05-06;Burgos;Todos;Técnicos sanitarios;69;5;1;4;9059
2020-05-06;León;Todos;Enfermero/a;1141;148;42;106;24089
2020-05-06;León;Todos;Fisioterapeuta;31;2;1;1;24089
2020-05-06;Palencia;Todos;Administrativo;63;5;1;4;34120
2020-05-06;Palencia;Todos;Celador;38;13;3;10;34120
2020-05-06;Palencia;Todos;Enfermero/a;211;45;10;35;34120
2020-05-06;Palencia;Todos;Fisioterapeuta;9;2;1;1;34120
2020-05-06;Palencia;Todos;Otros sanitarios;7;1;0;1;34120
2020-05-06;Palencia;Todos;Servicios de apoyo no sanitario;14;3;1;2;34120
2020-05-06;Salamanca;Todos;Celador;98;25;6;19;37274
2020-05-06;Salamanca;Todos;Médicos;641;147;48;99;37274
2020-05-06;Segovia;Todos;Otros;0;0;0;0;40004
2020-05-06;Segovia;Todos;Personal en formación;65;20;6;14;40004
2020-05-06;Soria;Todos;Administrativo;94;20;5;15;42173
2020-05-06;Soria;Todos;Auxiliares sanitarios;202;44;16;28;42173
2020-05-06;Soria;Todos;Personal en formación;28;2;1;1;42173
2020-05-06;Valladolid;Todos;Auxiliares sanitarios;349;61;22;39;47186
2020-05-06;Valladolid;Todos;Enfermero/a;1031;155;38;117;47186
2020-05-06;Valladolid;Todos;Fisioterapeuta;42;4;1;3;47186
2020-05-06;Valladolid;Todos;Otros;5;0;0;0;47186
2020-05-06;Valladolid;Todos;Servicios de apoyo no sanitario;51;9;2;7;47186
2020-05-06;Valladolid;Todos;Técnicos sanitarios;97;12;3;9;47186
2020-05-06;Zamora;Todos;Fisioterapeuta;14;1;1;0;49275
2020-05-06;Zamora;Todos;Servicios de apoyo no sanitario;1;0;0;0;49275
2020-05-07;Ávila;Todos;Administrativo;63;21;17;4;5019
2020-05-07;Ávila;Todos;Celador;117;13;10;3;5019
2020-05-07;Ávila;Todos;Otros sanitarios;15;5;4;1;5019
2020-05-07;Ávila;Todos;Personal en formación;37;4;1;3;5019
2020-05-07;Ávila;Todos;Técnicos sanitarios;45;10;6;4;5019
2020-05-07;Burgos;Todos;Auxiliares sanitarios;548;68;21;47;9059
2020-05-07;Burgos;Todos;Enfermero/a;1081;106;34;72;9059
2020-05-07;Burgos;Todos;Otros;11;2;1;1;9059
2020-05-07;Burgos;Todos;Servicios de apoyo no sanitario;34;3;1;2;9059
2020-05-07;Burgos;Todos;Técnicos sanitarios;74;5;1;4;9059
2020-05-07;León;Todos;Auxiliares sanitarios;497;69;25;44;24089
2020-05-07;León;Todos;Celador;257;20;11;9;24089
2020-05-07;León;Todos;Médicos;790;101;18;83;24089
2020-05-07;León;Todos;Otros;6;0;0;0;24089
2020-05-07;Palencia;Todos;Administrativo;71;5;4;1;34120
2020-05-07;Palencia;Todos;Enfermero/a;246;46;11;35;34120
2020-05-07;Palencia;Todos;Otros;5;1;1;0;34120
2020-05-07;Palencia;Todos;Personal en formación;23;6;0;6;34120
2020-05-07;Palencia;Todos;Servicios de apoyo no sanitario;14;3;1;2;34120
2020-05-07;Salamanca;Todos;Administrativo;178;26;12;14;37274
2020-05-07;Salamanca;Todos;Médicos;646;147;45;102;37274
2020-05-07;Salamanca;Todos;Otros sanitarios;17;4;3;1;37274
2020-05-07;Salamanca;Todos;Personal en formación;125;33;11;22;37274
2020-05-07;Salamanca;Todos;Técnicos sanitarios;55;18;3;15;37274
2020-05-07;Segovia;Todos;Fisioterapeuta;8;2;1;1;40004
2020-05-07;Segovia;Todos;Personal en formación;66;21;8;13;40004
2020-05-07;Segovia;Todos;Servicios de apoyo no sanitario;29;11;2;9;40004
2020-05-07;Soria;Todos;Administrativo;102;21;6;15;42173
2020-05-07;Soria;Todos;Celador;102;14;1;13;42173
2020-05-07;Soria;Todos;Enfermero/a;402;103;36;67;42173
2020-05-07;Soria;Todos;Fisioterapeuta;13;2;0;2;42173
2020-05-07;Valladolid;Todos;Celador;115;22;8;14;47186
2020-05-07;Valladolid;Todos;Médicos;858;107;21;86;47186
2020-05-07;Valladolid;Todos;Otros;6;0;0;0;47186
2020-05-08;Ávila;Todos;Administrativo;66;22;17;5;5019
2020-05-08;Ávila;Todos;Celador;122;14;9;5;5019
2020-05-08;Ávila;Todos;Fisioterapeuta;14;0;0;0;5019
2020-05-08;Ávila;Todos;Otros sanitarios;15;5;4;1;5019
2020-05-08;Ávila;Todos;Personal en formación;37;4;1;3;5019
2020-05-08;Burgos;Todos;Celador;174;20;4;16;9059
2020-05-08;Burgos;Todos;Técnicos sanitarios;75;5;1;4;9059
2020-05-08;León;Todos;Enfermero/a;1185;149;41;108;24089
2020-05-08;León;Todos;Médicos;800;101;18;83;24089
2020-05-08;León;Todos;Personal en formación;168;18;4;14;24089
2020-05-08;Palencia;Todos;Celador;44;13;2;11;34120
2020-05-08;Palencia;Todos;Médicos;230;33;5;28;34120
2020-05-08;Palencia;Todos;Otros;5;1;1;0;34120
2020-05-08;Salamanca;Todos;Administrativo;181;26;12;14;37274
2020-05-08;Salamanca;Todos;Enfermero/a;752;144;39;105;37274
2020-05-08;Salamanca;Todos;Médicos;654;148;44;104;37274
2020-05-08;Salamanca;Todos;Otros;8;5;3;2;37274
2020-05-08;Salamanca;Todos;Otros sanitarios;17;4;3;1;37274
2020-05-08;Salamanca;Todos;Servicios de apoyo no sanitario;42;14;2;12;37274
2020-05-08;Segovia;Todos;Administrativo;134;28;12;16;40004
2020-05-08;Segovia;Todos;Auxiliares sanitarios;293;81;36;45;40004
2020-05-08;Segovia;Todos;Fisioterapeuta;8;2;1;1;40004
2020-05-08;Segovia;Todos;Técnicos sanitarios;65;15;5;10;40004
2020-05-08;Soria;Todos;Auxiliares sanitarios;240;50;21;29;42173
2020-05-08;Soria;Todos;Enfermero/a;430;106;34;72;42173
2020-05-08;Soria;Todos;Médicos;280;75;27;48;42173
2020-05-08;Valladolid;Todos;Celador;116;22;8;14;47186
2020-05-08;Valladolid;Todos;Otros;6;0;0;0;47186
2020-05-08;Valladolid;Todos;Personal en formación;202;23;5;18;47186
2020-05-08;Valladolid;Todos;Servicios de apoyo no sanitario;44;8;3;5;47186
2020-05-08;Zamora;Todos;Auxiliares sanitarios;131;11;5;6;49275
2020-05-08;Zamora;Todos;Enfermero/a;355;29;18;11;49275
2020-05-08;Zamora;Todos;Fisioterapeuta;14;1;0;1;49275
2020-05-08;Zamora;Todos;Otros;0;0;0;0;49275
2020-05-09;Ávila;Todos;Auxiliares sanitarios;226;55;32;23;5019
2020-05-09;Ávila;Todos;Fisioterapeuta;8;0;0;0;5019
2020-05-09;Ávila;Todos;Personal en formación;27;4;3;1;5019
2020-05-09;Ávila;Todos;Servicios de apoyo no sanitario;28;10;6;4;5019
2020-05-09;Burgos;Todos;Administrativo;59;9;0;9;9059
2020-05-09;Burgos;Todos;Servicios de apoyo no sanitario;24;3;1;2;9059
2020-05-09;Burgos;Todos;Técnicos sanitarios;65;5;1;4;9059
2020-05-09;León;Todos;Auxiliares sanitarios;412;72;15;57;24089
2020-05-09;León;Todos;Fisioterapeuta;19;2;1;1;24089
2020-05-09;León;Todos;Médicos;495;98;6;92;24089
2020-05-09;León;Todos;Otros sanitarios;17;3;0;3;24089
2020-05-09;León;Todos;Personal en formación;121;18;3;15;24089
2020-05-09;Palencia;Todos;Auxiliares sanitarios;86;20;4;16;34120
2020-05-09;Palencia;Todos;Médicos;122;32;2;30;34120
2020-05-09;Palencia;Todos;Otros sanitarios;6;2;0;2;34120
2020-05-09;Salamanca;Todos;Celador;80;25;5;20;37274
2020-05-09;Salamanca;Todos;Enfermero/a;430;137;29;108;37274
2020-05-09;Salamanca;Todos;Personal en formación;82;31;6;25;37274
2020-05-09;Segovia;Todos;Auxiliares sanitarios;159;78;3;75;40004
2020-05-09;Segovia;Todos;Celador;72;38;1;37;40004
2020-05-09;Segovia;Todos;Médicos;226;104;10;94;40004
2020-05-09;Segovia;Todos;Otros;0;0;0;0;40004
2020-05-09;Segovia;Todos;Técnicos sanitarios;31;13;0;13;40004
2020-05-09;Soria;Todos;Administrativo;30;20;3;17;42173
2020-05-09;Soria;Todos;Fisioterapeuta;4;2;0;2;42173
2020-05-09;Soria;Todos;Otros sanitarios;4;2;0;2;42173
2020-05-09;Soria;Todos;Personal en formación;9;2;1;1;42173
2020-05-09;Soria;Todos;Servicios de apoyo no sanitario;8;5;0;5;42173
2020-05-09;Zamora;Todos;Enfermero/a;97;28;5;23;49275
2020-05-09;Zamora;Todos;Servicios de apoyo no sanitario;3;0;0;0;49275
2020-05-10;Ávila;Todos;Administrativo;35;18;13;5;5019
2020-05-10;Ávila;Todos;Celador;108;14;7;7;5019
2020-05-10;Ávila;Todos;Fisioterapeuta;8;0;0;0;5019
2020-05-10;Ávila;Todos;Otros;1;1;0;1;5019
2020-05-10;Burgos;Todos;Celador;79;20;3;17;9059
2020-05-10;Burgos;Todos;Enfermero/a;621;98;14;84;9059
2020-05-10;Burgos;Todos;Médicos;357;73;8;65;9059
2020-05-10;Burgos;Todos;Otros;3;2;1;1;9059
2020-05-10;Burgos;Todos;Servicios de apoyo no sanitario;24;3;1;2;9059
2020-05-10;León;Todos;Administrativo;71;16;1;15;24089
2020-05-10;León;Todos;Auxiliares sanitarios;413;73;16;57;24089
2020-05-10;León;Todos;Celador;138;23;8;15;24089
2020-05-10;León;Todos;Enfermero/a;761;146;26;120;24089
2020-05-10;León;Todos;Fisioterapeuta;19;2;1;1;24089
2020-05-10;León;Todos;Servicios de apoyo no sanitario;28;3;0;3;24089
2020-05-10;Palencia;Todos;Administrativo;18;6;1;5;34120
2020-05-10;Palencia;Todos;Auxiliares sanitarios;86;20;4;16;34120
2020-05-10;Palencia;Todos;Enfermero/a;141;47;4;43;34120
2020-05-10;Palencia;Todos;Fisioterapeuta;4;2;1;1;34120
2020-05-10;Palencia;Todos;Otros;3;1;1;0;34120
2020-05-10;Palencia;Todos;Otros sanitarios;6;2;0;2;34120
2020-05-10;Palencia;Todos;Técnicos sanitarios;10;3;0;3;34120
2020-05-10;Salamanca;Todos;Administrativo;66;23;7;16;37274
2020-05-10;Salamanca;Todos;Técnicos sanitarios;42;17;2;15;37274
2020-05-10;Segovia;Todos;Administrativo;67;27;0;27;40004
2020-05-10;Segovia;Todos;Celador;72;38;1;37;40004
2020-05-10;Segovia;Todos;Enfermero/a;323;162;7;155;40004
2020-05-10;Segovia;Todos;Otros sanitarios;5;3;1;2;40004
2020-05-10;Soria;Todos;Auxiliares sanitarios;81;41;9;32;42173
2020-05-10;Soria;Todos;Celador;24;12;0;12;42173
2020-05-10;Soria;Todos;Fisioterapeuta;4;2;0;2;42173
2020-05-10;Valladolid;Todos;Fisioterapeuta;20;4;0;4;47186
2020-05-10;Valladolid;Todos;Otros;5;0;0;0;47186
2020-05-10;Valladolid;Todos;Personal en formación;131;26;2;24;47186
2020-05-10;Zamora;Todos;Administrativo;14;7;0;7;49275
2020-05-10;Zamora;Todos;Auxiliares sanitarios;39;13;2;11;49275
2020-05-10;Zamora;Todos;Otros sanitarios;3;1;0;1;49275
2020-05-10;Zamora;Todos;Personal en formación;5;0;0;0;49275
2020-05-10;Zamora;Todos;Técnicos sanitarios;7;0;0;0;49275
2020-05-11;Ávila;Todos;Fisioterapeuta;8;0;0;0;5019
2020-05-11;Ávila;Todos;Médicos;242;80;36;44;5019
2020-05-11;Ávila;Todos;Servicios de apoyo no sanitario;29;11;6;5;5019
2020-05-11;Burgos;Todos;Médicos;364;74;8;66;9059
2020-05-11;Burgos;Todos;Otros sanitarios;15;0;0;0;9059
2020-05-11;Burgos;Todos;Servicios de apoyo no sanitario;24;3;1;2;9059
2020-05-11;León;Todos;Otros;5;0;0;0;24089
2020-05-11;León;Todos;Personal en formación;122;18;3;15;24089
2020-05-11;León;Todos;Técnicos sanitarios;49;7;1;6;24089
2020-05-11;Palencia;Todos;Auxiliares sanitarios;86;20;3;17;34120
2020-05-11;Palencia;Todos;Enfermero/a;141;47;4;43;34120
2020-05-11;Palencia;Todos;Técnicos sanitarios;11;3;0;3;34120
2020-05-11;Salamanca;Todos;Administrativo;67;23;7;16;37274
2020-05-11;Salamanca;Todos;Celador;81;25;5;20;37274
2020-05-11;Salamanca;Todos;Fisioterapeuta;12;6;1;5;37274
2020-05-11;Salamanca;Todos;Servicios de apoyo no sanitario;40;14;3;11;37274
2020-05-11;Salamanca;Todos;Técnicos sanitarios;42;17;2;15;37274
2020-05-11;Segovia;Todos;Celador;72;38;1;37;40004
2020-05-11;Segovia;Todos;Fisioterapeuta;4;1;0;1;40004
2020-05-11;Segovia;Todos;Técnicos sanitarios;32;14;0;14;40004
2020-05-11;Soria;Todos;Administrativo;38;27;6;21;42173
2020-05-11;Soria;Todos;Auxiliares sanitarios;83;42;9;33;42173
2020-05-11;Soria;Todos;Celador;24;12;0;12;42173
2020-05-11;Soria;Todos;Fisioterapeuta;4;2;0;2;42173
2020-05-11;Valladolid;Todos;Administrativo;146;33;3;30;47186
2020-05-11;Valladolid;Todos;Servicios de apoyo no sanitario;73;13;1;12;47186
2020-05-11;Valladolid;Todos;Técnicos sanitarios;89;13;0;13;47186
2020-05-11;Zamora;Todos;Fisioterapeuta;2;1;0;1;49275
2020-05-11;Zamora;Todos;Médicos;107;24;1;23;49275
2020-05-11;Zamora;Todos;Otros sanitarios;4;1;0;1;49275
2020-05-11;Zamora;Todos;Personal en formación;6;1;0;1;49275
2020-05-11;Zamora;Todos;Técnicos sanitarios;8;1;0;1;49275
2020-05-12;Ávila;Todos;Fisioterapeuta;8;0;0;0;5019
2020-05-12;Burgos;Todos;Médicos;367;77;7;70;9059
2020-05-12;Burgos;Todos;Otros sanitarios;15;0;0;0;9059
2020-05-12;Burgos;Todos;Personal en formación;49;6;0;6;9059
2020-05-12;Burgos;Todos;Servicios de apoyo no sanitario;24;3;1;2;9059
2020-05-12;León;Todos;Administrativo;116;17;1;16;24089
2020-05-12;León;Todos;Celador;183;23;5;18;24089
2020-05-12;León;Todos;Técnicos sanitarios;49;7;1;6;24089
2020-05-12;Palencia;Todos;Administrativo;16;7;1;6;34120
2020-05-12;Palencia;Todos;Médicos;126;33;3;30;34120
2020-05-12;Salamanca;Todos;Auxiliares sanitarios;250;86;19;67;37274
2020-05-12;Salamanca;Todos;Enfermero/a;441;138;25;113;37274
2020-05-12;Salamanca;Todos;Otros;3;2;1;1;37274
2020-05-12;Salamanca;Todos;Servicios de apoyo no sanitario;40;14;3;11;37274
2020-05-12;Segovia;Todos;Auxiliares sanitarios;163;81;1;80;40004
2020-05-12;Segovia;Todos;Fisioterapeuta;4;1;0;1;40004
2020-05-12;Segovia;Todos;Personal en formación;41;21;1;20;40004
2020-05-12;Soria;Todos;Administrativo;41;31;6;25;42173
2020-05-12;Soria;Todos;Auxiliares sanitarios;84;43;9;34;42173
2020-05-12;Soria;Todos;Celador;25;12;0;12;42173
2020-05-12;Soria;Todos;Otros sanitarios;4;2;0;2;42173
2020-05-12;Soria;Todos;Personal en formación;9;2;1;1;42173
2020-05-12;Soria;Todos;Servicios de apoyo no sanitario;11;8;0;8;42173
2020-05-12;Valladolid;Todos;Auxiliares sanitarios;401;70;16;54;47186
2020-05-12;Valladolid;Todos;Celador;109;25;6;19;47186
2020-05-12;Valladolid;Todos;Personal en formación;132;27;1;26;47186
2020-05-12;Valladolid;Todos;Servicios de apoyo no sanitario;77;14;1;13;47186
2020-05-12;Zamora;Todos;Celador;21;7;0;7;49275
2020-05-12;Zamora;Todos;Fisioterapeuta;2;1;0;1;49275
2020-05-12;Zamora;Todos;Otros;0;0;0;0;49275
2020-05-12;Zamora;Todos;Otros sanitarios;4;1;0;1;49275
2020-05-12;Zamora;Todos;Personal en formación;6;1;0;1;49275
2020-05-13;Ávila;Todos;Administrativo;35;15;13;2;5019
2020-05-13;Ávila;Todos;Enfermero/a;389;83;60;23;5019
2020-05-13;Ávila;Todos;Médicos;247;67;33;34;5019
2020-05-13;Ávila;Todos;Otros;1;1;0;1;5019
2020-05-13;Ávila;Todos;Otros sanitarios;10;5;3;2;5019
2020-05-13;Burgos;Todos;Administrativo;67;8;0;8;9059
2020-05-13;Burgos;Todos;Celador;90;14;2;12;9059
2020-05-13;Burgos;Todos;Fisioterapeuta;10;2;1;1;9059
2020-05-13;Burgos;Todos;Médicos;369;56;7;49;9059
2020-05-13;Burgos;Todos;Otros;3;1;1;0;9059
2020-05-13;Burgos;Todos;Servicios de apoyo no sanitario;25;3;1;2;9059
2020-05-13;León;Todos;Auxiliares sanitarios;468;56;11;45;24089
2020-05-13;León;Todos;Servicios de apoyo no sanitario;83;4;1;3;24089
2020-05-13;Palencia;Todos;Administrativo;20;4;1;3;34120
2020-05-13;Palencia;Todos;Auxiliares sanitarios;94;19;3;16;34120
2020-05-13;Palencia;Todos;Otros;3;1;1;0;34120
2020-05-13;Palencia;Todos;Otros sanitarios;6;1;0;1;34120
2020-05-13;Palencia;Todos;Personal en formación;22;8;2;6;34120
2020-05-13;Segovia;Todos;Administrativo;68;16;0;16;40004
2020-05-13;Segovia;Todos;Celador;81;21;1;20;40004
2020-05-13;Segovia;Todos;Enfermero/a;330;122;4;118;40004
2020-05-13;Segovia;Todos;Otros sanitarios;6;1;1;0;40004
2020-05-13;Segovia;Todos;Técnicos sanitarios;33;13;0;13;40004
2020-05-13;Soria;Todos;Auxiliares sanitarios;84;26;9;17;42173
2020-05-13;Soria;Todos;Celador;25;9;0;9;42173
2020-05-13;Soria;Todos;Enfermero/a;154;64;11;53;42173
2020-05-13;Soria;Todos;Fisioterapeuta;4;1;0;1;42173
2020-05-13;Soria;Todos;Médicos;109;52;7;45;42173
2020-05-13;Valladolid;Todos;Auxiliares sanitarios;405;67;15;52;47186
2020-05-13;Valladolid;Todos;Personal en formación;133;22;1;21;47186
2020-05-13;Valladolid;Todos;Servicios de apoyo no sanitario;78;8;1;7;47186
2020-05-13;Zamora;Todos;Enfermero/a;104;21;3;18;49275
2020-05-13;Zamora;Todos;Médicos;107;18;1;17;49275
2020-05-13;Zamora;Todos;Otros sanitarios;4;1;0;1;49275
2020-05-14;Ávila;Todos;Administrativo;35;15;13;2;5019
2020-05-14;Ávila;Todos;Enfermero/a;389;83;60;23;5019
2020-05-14;Ávila;Todos;Personal en formación;28;4;3;1;5019
2020-05-14;Ávila;Todos;Técnicos sanitarios;32;5;4;1;5019
2020-05-14;Burgos;Todos;Administrativo;70;8;0;8;9059
2020-05-14;Burgos;Todos;Auxiliares sanitarios;420;51;13;38;9059
2020-05-14;Burgos;Todos;Otros;3;1;1;0;9059
2020-05-14;Burgos;Todos;Otros sanitarios;17;0;0;0;9059
2020-05-14;Burgos;Todos;Servicios de apoyo no sanitario;29;3;1;2;9059
2020-05-14;León;Todos;Administrativo;126;8;1;7;24089
2020-05-14;León;Todos;Enfermero/a;889;121;18;103;24089
2020-05-14;León;Todos;Médicos;556;78;2;76;24089
2020-05-14;León;Todos;Otros;5;0;0;0;24089
2020-05-14;León;Todos;Otros sanitarios;20;3;0;3;24089
2020-05-14;León;Todos;Servicios de apoyo no sanitario;83;4;2;2;24089
2020-05-14;León;Todos;Técnicos sanitarios;50;6;1;5;24089
2020-05-14;Salamanca;Todos;Auxiliares sanitarios;262;80;14;66;37274
2020-05-14;Salamanca;Todos;Otros;6;2;1;1;37274
2020-05-14;Salamanca;Todos;Otros sanitarios;7;4;3;1;37274
2020-05-14;Salamanca;Todos;Técnicos sanitarios;43;16;1;15;37274
2020-05-14;Segovia;Todos;Fisioterapeuta;4;1;0;1;40004
2020-05-14;Segovia;Todos;Otros;0;0;0;0;40004
2020-05-14;Segovia;Todos;Personal en formación;41;13;1;12;40004
2020-05-14;Soria;Todos;Administrativo;42;14;6;8;42173
2020-05-14;Soria;Todos;Auxiliares sanitarios;87;26;9;17;42173
2020-05-14;Soria;Todos;Otros sanitarios;4;2;0;2;42173
2020-05-14;Valladolid;Todos;Administrativo;152;21;2;19;47186
2020-05-14;Valladolid;Todos;Médicos;617;100;8;92;47186
2020-05-14;Valladolid;Todos;Servicios de apoyo no sanitario;78;8;1;7;47186
2020-05-14;Zamora;Todos;Administrativo;19;1;0;1;49275
2020-05-14;Zamora;Todos;Auxiliares sanitarios;47;5;1;4;49275
2020-05-14;Zamora;Todos;Enfermero/a;104;21;2;19;49275
2020-05-14;Zamora;Todos;Otros sanitarios;4;1;0;1;49275
2020-05-15;Ávila;Todos;Administrativo;35;15;13;2;5019
2020-05-15;Ávila;Todos;Enfermero/a;390;83;59;24;5019
2020-05-15;Ávila;Todos;Técnicos sanitarios;32;5;4;1;5019
2020-05-15;Burgos;Todos;Celador;100;14;1;13;9059
2020-05-15;Burgos;Todos;Fisioterapeuta;14;2;1;1;9059
2020-05-15;Burgos;Todos;Otros;3;1;1;0;9059
2020-05-15;Burgos;Todos;Otros sanitarios;17;0;0;0;9059
2020-05-15;Burgos;Todos;Técnicos sanitarios;78;5;0;5;9059
2020-05-15;León;Todos;Enfermero/a;931;121;17;104;24089
2020-05-15;León;Todos;Médicos;570;79;3;76;24089
2020-05-15;León;Todos;Otros sanitarios;20;3;0;3;24089
2020-05-15;León;Todos;Servicios de apoyo no sanitario;83;4;2;2;24089
2020-05-15;Palencia;Todos;Médicos;133;30;3;27;34120
2020-05-15;Palencia;Todos;Servicios de apoyo no sanitario;12;3;0;3;34120
2020-05-15;Salamanca;Todos;Auxiliares sanitarios;266;80;12;68;37274
2020-05-15;Salamanca;Todos;Fisioterapeuta;12;5;1;4;37274
2020-05-15;Salamanca;Todos;Personal en formación;91;24;7;17;37274
2020-05-15;Salamanca;Todos;Técnicos sanitarios;44;16;1;15;37274
2020-05-15;Segovia;Todos;Celador;82;21;1;20;40004
2020-05-15;Segovia;Todos;Enfermero/a;335;122;3;119;40004
2020-05-15;Segovia;Todos;Fisioterapeuta;4;1;0;1;40004
2020-05-15;Segovia;Todos;Personal en formación;41;13;1;12;40004
2020-05-15;Segovia;Todos;Técnicos sanitarios;33;13;0;13;40004
2020-05-15;Soria;Todos;Auxiliares sanitarios;87;26;8;18;42173
2020-05-15;Soria;Todos;Médicos;115;52;7;45;42173
2020-05-15;Soria;Todos;Servicios de apoyo no sanitario;15;2;0;2;42173
2020-05-15;Valladolid;Todos;Auxiliares sanitarios;408;66;11;55;47186
2020-05-15;Valladolid;Todos;Fisioterapeuta;24;3;0;3;47186
2020-05-15;Valladolid;Todos;Otros;5;0;0;0;47186
2020-05-15;Zamora;Todos;Administrativo;20;1;0;1;49275
2020-05-15;Zamora;Todos;Enfermero/a;109;21;2;19;49275
2020-05-15;Zamora;Todos;Técnicos sanitarios;11;0;0;0;49275
2020-05-16;Ávila;Todos;Administrativo;35;15;13;2;5019
2020-05-16;Ávila;Todos;Celador;110;9;6;3;5019
2020-05-16;Ávila;Todos;Médicos;251;67;31;36;5019
2020-05-16;Ávila;Todos;Otros;3;1;0;1;5019
2020-05-16;Ávila;Todos;Otros sanitarios;10;5;3;2;5019
2020-05-16;Ávila;Todos;Técnicos sanitarios;32;5;4;1;5019
2020-05-16;Burgos;Todos;Celador;100;14;1;13;9059
2020-05-16;Burgos;Todos;Enfermero/a;672;81;8;73;9059
2020-05-16;Burgos;Todos;Personal en formación;51;5;0;5;9059
2020-05-16;León;Todos;Fisioterapeuta;21;2;0;2;24089
2020-05-16;León;Todos;Médicos;582;80;5;75;24089
2020-05-16;León;Todos;Otros;6;0;0;0;24089
2020-05-16;León;Todos;Personal en formación;127;15;2;13;24089
2020-05-16;Palencia;Todos;Auxiliares sanitarios;94;19;2;17;34120
2020-05-16;Palencia;Todos;Celador;37;13;3;10;34120
2020-05-16;Palencia;Todos;Enfermero/a;152;41;4;37;34120
2020-05-16;Palencia;Todos;Fisioterapeuta;4;2;1;1;34120
2020-05-16;Palencia;Todos;Servicios de apoyo no sanitario;12;3;0;3;34120
2020-05-16;Palencia;Todos;Técnicos sanitarios;13;3;0;3;34120
2020-05-16;Salamanca;Todos;Administrativo;69;20;6;14;37274
2020-05-16;Salamanca;Todos;Auxiliares sanitarios;267;81;13;68;37274
2020-05-16;Salamanca;Todos;Enfermero/a;457;119;23;96;37274
2020-05-16;Salamanca;Todos;Otros;6;2;1;1;37274
2020-05-16;Salamanca;Todos;Personal en formación;91;24;7;17;37274
2020-05-16;Salamanca;Todos;Técnicos sanitarios;44;16;1;15;37274
2020-05-16;Segovia;Todos;Auxiliares sanitarios;169;49;1;48;40004
2020-05-16;Segovia;Todos;Enfermero/a;337;122;3;119;40004
2020-05-16;Soria;Todos;Fisioterapeuta;4;1;0;1;42173
2020-05-16;Soria;Todos;Otros;0;0;0;0;42173
2020-05-16;Soria;Todos;Personal en formación;9;2;1;1;42173
2020-05-16;Soria;Todos;Servicios de apoyo no sanitario;15;2;0;2;42173
2020-05-16;Soria;Todos;Técnicos sanitarios;14;8;0;8;42173
2020-05-16;Valladolid;Todos;Otros;5;0;0;0;47186
2020-05-16;Zamora;Todos;Administrativo;20;1;0;1;49275
2020-05-16;Zamora;Todos;Enfermero/a;109;21;2;19;49275
2020-05-16;Zamora;Todos;Fisioterapeuta;2;0;0;0;49275
2020-05-16;Zamora;Todos;Otros;0;0;0;0;49275
2020-05-17;Ávila;Todos;Enfermero/a;394;83;58;25;5019
2020-05-17;Ávila;Todos;Otros;3;1;0;1;5019
2020-05-17;Ávila;Todos;Técnicos sanitarios;32;5;4;1;5019
2020-05-17;Burgos;Todos;Celador;100;14;1;13;9059
2020-05-17;Burgos;Todos;Enfermero/a;675;81;7;74;9059
2020-05-17;Burgos;Todos;Fisioterapeuta;17;2;1;1;9059
2020-05-17;Burgos;Todos;Médicos;385;56;6;50;9059
2020-05-17;Burgos;Todos;Otros;3;1;1;0;9059
2020-05-17;León;Todos;Celador;184;16;3;13;24089
2020-05-17;León;Todos;Otros;6;0;0;0;24089
2020-05-17;León;Todos;Otros sanitarios;20;3;0;3;24089
2020-05-17;León;Todos;Personal en formación;127;15;2;13;24089
2020-05-17;Palencia;Todos;Administrativo;21;4;1;3;34120
2020-05-17;Palencia;Todos;Enfermero/a;152;41;4;37;34120
2020-05-17;Palencia;Todos;Otros sanitarios;6;1;0;1;34120
2020-05-17;Palencia;Todos;Servicios de apoyo no sanitario;12;3;0;3;34120
2020-05-17;Salamanca;Todos;Auxiliares sanitarios;267;81;13;68;37274
2020-05-17;Salamanca;Todos;Enfermero/a;458;119;23;96;37274
2020-05-17;Salamanca;Todos;Fisioterapeuta;12;5;1;4;37274
2020-05-17;Salamanca;Todos;Médicos;380;120;17;103;37274
2020-05-17;Salamanca;Todos;Otros sanitarios;8;4;3;1;37274
2020-05-17;Salamanca;Todos;Servicios de apoyo no sanitario;45;12;3;9;37274
2020-05-17;Segovia;Todos;Administrativo;69;16;0;16;40004
2020-05-17;Segovia;Todos;Enfermero/a;337;122;3;119;40004
2020-05-17;Segovia;Todos;Médicos;242;75;8;67;40004
2020-05-17;Segovia;Todos;Otros;0;0;0;0;40004
2020-05-17;Segovia;Todos;Otros sanitarios;6;1;1;0;40004
2020-05-17;Segovia;Todos;Servicios de apoyo no sanitario;29;10;1;9;40004
2020-05-17;Soria;Todos;Enfermero/a;166;64;10;54;42173
2020-05-17;Soria;Todos;Otros;0;0;0;0;42173
2020-05-17;Soria;Todos;Técnicos sanitarios;14;8;0;8;42173
2020-05-17;Valladolid;Todos;Celador;112;22;6;16;47186
2020-05-17;Valladolid;Todos;Enfermero/a;889;148;13;135;47186
2020-05-17;Valladolid;Todos;Médicos;620;100;7;93;47186
2020-05-17;Valladolid;Todos;Personal en formación;134;22;0;22;47186
2020-05-17;Valladolid;Todos;Servicios de apoyo no sanitario;79;8;1;7;47186
2020-05-17;Valladolid;Todos;Técnicos sanitarios;93;9;0;9;47186
2020-05-17;Zamora;Todos;Administrativo;20;1;0;1;49275
2020-05-17;Zamora;Todos;Auxiliares sanitarios;49;5;1;4;49275
2020-05-17;Zamora;Todos;Otros;0;0;0;0;49275
2020-05-17;Zamora;Todos;Otros sanitarios;4;1;0;1;49275
2020-05-17;Zamora;Todos;Servicios de apoyo no sanitario;4;0;0;0;49275
2020-05-17;Zamora;Todos;Técnicos sanitarios;11;0;0;0;49275
2020-05-18;Ávila;Todos;Otros;3;1;0;1;5019
2020-05-18;Ávila;Todos;Personal en formación;28;4;3;1;5019
2020-05-18;Ávila;Todos;Técnicos sanitarios;32;5;4;1;5019
2020-05-18;Burgos;Todos;Auxiliares sanitarios;448;52;12;40;9059
2020-05-18;Burgos;Todos;Enfermero/a;706;81;7;74;9059
2020-05-18;León;Todos;Auxiliares sanitarios;541;56;6;50;24089
2020-05-18;León;Todos;Celador;199;16;2;14;24089
2020-05-18;León;Todos;Médicos;611;80;4;76;24089
2020-05-18;León;Todos;Otros;6;0;0;0;24089
2020-05-18;León;Todos;Otros sanitarios;20;3;0;3;24089
2020-05-18;Palencia;Todos;Administrativo;21;4;1;3;34120
2020-05-18;Palencia;Todos;Celador;38;13;3;10;34120
2020-05-18;Palencia;Todos;Enfermero/a;157;41;4;37;34120
2020-05-18;Palencia;Todos;Fisioterapeuta;4;2;1;1;34120
2020-05-18;Palencia;Todos;Otros;3;1;1;0;34120
2020-05-18;Salamanca;Todos;Administrativo;72;20;6;14;37274
2020-05-18;Salamanca;Todos;Fisioterapeuta;12;5;1;4;37274
2020-05-18;Salamanca;Todos;Médicos;384;120;17;103;37274
2020-05-18;Salamanca;Todos;Otros sanitarios;8;4;3;1;37274
2020-05-18;Salamanca;Todos;Personal en formación;92;24;7;17;37274
2020-05-18;Salamanca;Todos;Técnicos sanitarios;44;16;1;15;37274
2020-05-18;Segovia;Todos;Celador;82;21;1;20;40004
2020-05-18;Segovia;Todos;Otros;0;0;0;0;40004
2020-05-18;Segovia;Todos;Servicios de apoyo no sanitario;29;10;1;9;40004
2020-05-18;Soria;Todos;Administrativo;44;14;5;9;42173
2020-05-18;Soria;Todos;Personal en formación;9;2;1;1;42173
2020-05-18;Soria;Todos;Técnicos sanitarios;14;8;0;8;42173
2020-05-18;Valladolid;Todos;Administrativo;156;22;3;19;47186
2020-05-18;Valladolid;Todos;Auxiliares sanitarios;414;67;10;57;47186
2020-05-18;Valladolid;Todos;Celador;114;22;6;16;47186
2020-05-18;Valladolid;Todos;Enfermero/a;892;149;14;135;47186
2020-05-18;Valladolid;Todos;Fisioterapeuta;24;3;0;3;47186
2020-05-18;Valladolid;Todos;Otros;5;0;0;0;47186
2020-05-18;Valladolid;Todos;Otros sanitarios;18;4;0;4;47186
2020-05-18;Zamora;Todos;Celador;27;3;0;3;49275
2020-05-18;Zamora;Todos;Fisioterapeuta;4;0;0;0;49275
2020-05-18;Zamora;Todos;Médicos;117;20;2;18;49275
2020-05-18;Zamora;Todos;Otros;0;0;0;0;49275
2020-05-19;Ávila;Todos;Enfermero/a;394;85;59;26;5019
2020-05-19;Ávila;Todos;Médicos;254;67;31;36;5019
2020-05-19;Ávila;Todos;Otros;3;1;0;1;5019
2020-05-19;Burgos;Todos;Auxiliares sanitarios;473;52;11;41;9059
2020-05-19;Burgos;Todos;Fisioterapeuta;18;2;1;1;9059
2020-05-19;Burgos;Todos;Personal en formación;62;5;0;5;9059
2020-05-19;Burgos;Todos;Servicios de apoyo no sanitario;38;3;1;2;9059
2020-05-19;Burgos;Todos;Técnicos sanitarios;86;5;0;5;9059
2020-05-19;León;Todos;Administrativo;151;8;1;7;24089
2020-05-19;León;Todos;Auxiliares sanitarios;558;56;6;50;24089
2020-05-19;León;Todos;Médicos;630;80;4;76;24089
2020-05-19;León;Todos;Otros;6;0;0;0;24089
2020-05-19;León;Todos;Técnicos sanitarios;138;7;2;5;24089
2020-05-19;Palencia;Todos;Enfermero/a;160;41;4;37;34120
2020-05-19;Palencia;Todos;Médicos;137;30;3;27;34120
2020-05-19;Palencia;Todos;Otros sanitarios;6;1;0;1;34120
2020-05-19;Salamanca;Todos;Administrativo;72;20;6;14;37274
2020-05-19;Salamanca;Todos;Fisioterapeuta;12;5;1;4;37274
2020-05-19;Salamanca;Todos;Médicos;384;120;16;104;37274
2020-05-19;Salamanca;Todos;Servicios de apoyo no sanitario;47;12;3;9;37274
2020-05-19;Segovia;Todos;Auxiliares sanitarios;171;49;1;48;40004
2020-05-19;Segovia;Todos;Celador;84;21;1;20;40004
2020-05-19;Segovia;Todos;Técnicos sanitarios;33;13;0;13;40004
2020-05-19;Soria;Todos;Enfermero/a;168;64;10;54;42173
2020-05-19;Soria;Todos;Fisioterapeuta;4;1;0;1;42173
2020-05-19;Soria;Todos;Médicos;117;52;7;45;42173
2020-05-19;Soria;Todos;Personal en formación;9;2;1;1;42173
2020-05-19;Valladolid;Todos;Celador;117;22;6;16;47186
2020-05-19;Valladolid;Todos;Fisioterapeuta;24;3;0;3;47186
2020-05-19;Valladolid;Todos;Técnicos sanitarios;93;9;0;9;47186
2020-05-19;Zamora;Todos;Enfermero/a;116;21;2;19;49275
2020-05-19;Zamora;Todos;Médicos;121;20;2;18;49275
2020-05-19;Zamora;Todos;Otros;0;0;0;0;49275
2020-05-20;Ávila;Todos;Administrativo;35;15;13;2;5019
2020-05-20;Ávila;Todos;Auxiliares sanitarios;227;42;28;14;5019
2020-05-20;Ávila;Todos;Enfermero/a;394;85;59;26;5019
2020-05-20;Ávila;Todos;Otros;3;1;0;1;5019
2020-05-20;Ávila;Todos;Otros sanitarios;10;5;3;2;5019
2020-05-20;Ávila;Todos;Personal en formación;28;4;3;1;5019
2020-05-20;Ávila;Todos;Servicios de apoyo no sanitario;29;8;6;2;5019
2020-05-20;Ávila;Todos;Técnicos sanitarios;32;5;3;2;5019
2020-05-20;Burgos;Todos;Administrativo;86;9;1;8;9059
2020-05-20;Burgos;Todos;Celador;112;14;1;13;9059
2020-05-20;Burgos;Todos;Fisioterapeuta;18;2;0;2;9059
2020-05-20;Burgos;Todos;Técnicos sanitarios;88;5;0;5;9059
2020-05-20;León;Todos;Administrativo;155;8;1;7;24089
2020-05-20;León;Todos;Médicos;649;80;3;77;24089
2020-05-20;León;Todos;Otros sanitarios;20;3;0;3;24089
2020-05-20;Palencia;Todos;Fisioterapeuta;5;2;0;2;34120
2020-05-20;Palencia;Todos;Personal en formación;24;8;2;6;34120
2020-05-20;Salamanca;Todos;Administrativo;79;20;6;14;37274
2020-05-20;Salamanca;Todos;Médicos;387;120;16;104;37274
2020-05-20;Salamanca;Todos;Otros sanitarios;9;4;3;1;37274
2020-05-20;Segovia;Todos;Auxiliares sanitarios;173;49;1;48;40004
2020-05-20;Segovia;Todos;Fisioterapeuta;4;1;0;1;40004
2020-05-20;Segovia;Todos;Otros sanitarios;6;1;1;0;40004
2020-05-20;Soria;Todos;Administrativo;44;14;5;9;42173
2020-05-20;Soria;Todos;Personal en formación;9;2;1;1;42173
2020-05-20;Valladolid;Todos;Médicos;635;100;4;96;47186
2020-05-20;Valladolid;Todos;Otros sanitarios;19;4;0;4;47186
2020-05-20;Valladolid;Todos;Servicios de apoyo no sanitario;83;8;1;7;47186
2020-05-20;Zamora;Todos;Administrativo;22;1;0;1;49275
2020-05-20;Zamora;Todos;Auxiliares sanitarios;52;5;1;4;49275
2020-05-20;Zamora;Todos;Celador;30;3;0;3;49275
2020-05-20;Zamora;Todos;Fisioterapeuta;4;0;0;0;49275
2020-05-20;Zamora;Todos;Técnicos sanitarios;12;0;0;0;49275
2020-05-21;Ávila;Todos;Administrativo;35;15;13;2;5019
2020-05-21;Ávila;Todos;Fisioterapeuta;8;0;0;0;5019
2020-05-21;Ávila;Todos;Otros sanitarios;10;5;3;2;5019
2020-05-21;Ávila;Todos;Servicios de apoyo no sanitario;29;8;6;2;5019
2020-05-21;Burgos;Todos;Médicos;434;57;7;50;9059
2020-05-21;Burgos;Todos;Otros sanitarios;18;0;0;0;9059
2020-05-21;Burgos;Todos;Servicios de apoyo no sanitario;42;4;2;2;9059
2020-05-21;León;Todos;Fisioterapeuta;28;2;0;2;24089
2020-05-21;León;Todos;Médicos;675;80;3;77;24089
2020-05-21;León;Todos;Otros;6;0;0;0;24089
2020-05-21;León;Todos;Servicios de apoyo no sanitario;85;4;1;3;24089
2020-05-21;Palencia;Todos;Administrativo;21;4;1;3;34120
2020-05-21;Palencia;Todos;Enfermero/a;166;42;5;37;34120
2020-05-21;Palencia;Todos;Médicos;137;30;3;27;34120
2020-05-21;Palencia;Todos;Otros;4;1;1;0;34120
2020-05-21;Salamanca;Todos;Administrativo;82;20;6;14;37274
2020-05-21;Salamanca;Todos;Celador;100;23;2;21;37274
2020-05-21;Salamanca;Todos;Fisioterapeuta;12;5;1;4;37274
2020-05-21;Segovia;Todos;Fisioterapeuta;4;1;0;1;40004
2020-05-21;Segovia;Todos;Médicos;244;75;8;67;40004
2020-05-21;Segovia;Todos;Otros;0;0;0;0;40004
2020-05-21;Soria;Todos;Administrativo;44;14;5;9;42173
2020-05-21;Soria;Todos;Auxiliares sanitarios;92;26;4;22;42173
2020-05-21;Soria;Todos;Enfermero/a;169;64;10;54;42173
2020-05-21;Soria;Todos;Médicos;117;52;6;46;42173
2020-05-21;Soria;Todos;Otros sanitarios;5;2;0;2;42173
2020-05-21;Soria;Todos;Personal en formación;10;2;1;1;42173
2020-05-21;Valladolid;Todos;Celador;128;23;6;17;47186
2020-05-21;Valladolid;Todos;Fisioterapeuta;24;3;0;3;47186
2020-05-21;Valladolid;Todos;Otros;5;0;0;0;47186
2020-05-21;Zamora;Todos;Personal en formación;8;0;0;0;49275
2020-05-21;Zamora;Todos;Servicios de apoyo no sanitario;5;0;0;0;49275
2020-05-21;Zamora;Todos;Técnicos sanitarios;12;0;0;0;49275
2020-05-22;Burgos;Todos;Administrativo;97;9;1;8;9059
2020-05-22;Burgos;Todos;Técnicos sanitarios;89;5;0;5;9059
2020-05-22;León;Todos;Celador;258;17;2;15;24089
2020-05-22;León;Todos;Médicos;685;80;2;78;24089
2020-05-22;León;Todos;Otros;6;0;0;0;24089
2020-05-22;León;Todos;Servicios de apoyo no sanitario;87;4;0;4;24089
2020-05-22;León;Todos;Técnicos sanitarios;186;7;2;5;24089
2020-05-22;Palencia;Todos;Médicos;137;30;3;27;34120
2020-05-22;Palencia;Todos;Otros;4;1;1;0;34120
2020-05-22;Palencia;Todos;Otros sanitarios;6;1;0;1;34120
2020-05-22;Palencia;Todos;Técnicos sanitarios;13;3;0;3;34120
2020-05-22;Salamanca;Todos;Celador;101;23;2;21;37274
2020-05-22;Salamanca;Todos;Enfermero/a;483;120;22;98;37274
2020-05-22;Salamanca;Todos;Otros;6;2;0;2;37274
2020-05-22;Salamanca;Todos;Servicios de apoyo no sanitario;57;12;1;11;37274
2020-05-22;Segovia;Todos;Auxiliares sanitarios;173;49;0;49;40004
2020-05-22;Segovia;Todos;Médicos;247;75;8;67;40004
2020-05-22;Soria;Todos;Enfermero/a;169;64;10;54;42173
2020-05-22;Soria;Todos;Otros;0;0;0;0;42173
2020-05-22;Soria;Todos;Otros sanitarios;5;2;0;2;42173
2020-05-22;Soria;Todos;Personal en formación;10;2;1;1;42173
2020-05-22;Soria;Todos;Técnicos sanitarios;14;8;0;8;42173
2020-05-22;Valladolid;Todos;Auxiliares sanitarios;456;68;4;64;47186
2020-05-22;Valladolid;Todos;Enfermero/a;948;149;11;138;47186
2020-05-22;Valladolid;Todos;Otros;5;0;0;0;47186
2020-05-22;Zamora;Todos;Otros;0;0;0;0;49275
2020-05-22;Zamora;Todos;Otros sanitarios;5;1;1;0;49275
2020-05-22;Zamora;Todos;Servicios de apoyo no sanitario;5;0;0;0;49275
2020-05-23;Ávila;Todos;Administrativo;35;15;13;2;5019
2020-05-23;Ávila;Todos;Otros;3;1;0;1;5019
2020-05-23;Ávila;Todos;Personal en formación;28;4;3;1;5019
2020-05-23;Burgos;Todos;Otros sanitarios;18;0;0;0;9059
2020-05-23;León;Todos;Fisioterapeuta;33;2;0;2;24089
2020-05-23;León;Todos;Personal en formación;144;15;0;15;24089
2020-05-23;León;Todos;Técnicos sanitarios;186;7;2;5;24089
2020-05-23;Palencia;Todos;Auxiliares sanitarios;98;21;5;16;34120
2020-05-23;Palencia;Todos;Enfermero/a;168;42;4;38;34120
2020-05-23;Palencia;Todos;Fisioterapeuta;5;2;0;2;34120
2020-05-23;Palencia;Todos;Otros sanitarios;6;1;0;1;34120
2020-05-23;Salamanca;Todos;Fisioterapeuta;13;5;1;4;37274
2020-05-23;Salamanca;Todos;Otros sanitarios;10;4;3;1;37274
2020-05-23;Salamanca;Todos;Personal en formación;99;24;6;18;37274
2020-05-23;Segovia;Todos;Otros;0;0;0;0;40004
2020-05-23;Segovia;Todos;Otros sanitarios;6;1;1;0;40004
2020-05-23;Segovia;Todos;Servicios de apoyo no sanitario;29;10;1;9;40004
2020-05-23;Soria;Todos;Celador;26;9;0;9;42173
2020-05-23;Soria;Todos;Enfermero/a;169;64;10;54;42173
2020-05-23;Soria;Todos;Personal en formación;10;2;1;1;42173
2020-05-23;Valladolid;Todos;Médicos;641;100;2;98;47186
2020-05-23;Valladolid;Todos;Otros sanitarios;19;4;0;4;47186
2020-05-23;Valladolid;Todos;Servicios de apoyo no sanitario;83;8;1;7;47186
2020-05-23;Valladolid;Todos;Técnicos sanitarios;100;9;0;9;47186
2020-05-23;Zamora;Todos;Celador;31;3;0;3;49275
2020-05-23;Zamora;Todos;Enfermero/a;122;21;2;19;49275
2020-05-23;Zamora;Todos;Otros;0;0;0;0;49275
2020-05-23;Zamora;Todos;Personal en formación;8;0;0;0;49275
2020-05-24;Ávila;Todos;Auxiliares sanitarios;228;42;25;17;5019
2020-05-24;Ávila;Todos;Fisioterapeuta;8;0;0;0;5019
2020-05-24;Ávila;Todos;Otros;3;1;0;1;5019
2020-05-24;Ávila;Todos;Técnicos sanitarios;32;5;3;2;5019
2020-05-24;Burgos;Todos;Administrativo;99;9;0;9;9059
2020-05-24;Burgos;Todos;Auxiliares sanitarios;535;52;11;41;9059
2020-05-24;Burgos;Todos;Médicos;440;57;7;50;9059
2020-05-24;Burgos;Todos;Otros sanitarios;18;0;0;0;9059
2020-05-24;Burgos;Todos;Técnicos sanitarios;89;5;0;5;9059
2020-05-24;León;Todos;Celador;258;17;2;15;24089
2020-05-24;León;Todos;Enfermero/a;1112;125;12;113;24089
2020-05-24;León;Todos;Servicios de apoyo no sanitario;88;4;0;4;24089
2020-05-24;León;Todos;Técnicos sanitarios;186;7;2;5;24089
2020-05-24;Palencia;Todos;Celador;39;12;1;11;34120
2020-05-24;Palencia;Todos;Médicos;137;30;3;27;34120
2020-05-24;Palencia;Todos;Otros;4;1;1;0;34120
2020-05-24;Palencia;Todos;Personal en formación;25;8;2;6;34120
2020-05-24;Salamanca;Todos;Administrativo;84;20;5;15;37274
2020-05-24;Salamanca;Todos;Personal en formación;99;24;6;18;37274
2020-05-24;Segovia;Todos;Administrativo;69;16;0;16;40004
2020-05-24;Segovia;Todos;Auxiliares sanitarios;174;49;0;49;40004
2020-05-24;Segovia;Todos;Fisioterapeuta;4;1;0;1;40004
2020-05-24;Segovia;Todos;Médicos;248;75;8;67;40004
2020-05-24;Segovia;Todos;Otros;0;0;0;0;40004
2020-05-24;Segovia;Todos;Servicios de apoyo no sanitario;29;10;1;9;40004
2020-05-24;Soria;Todos;Médicos;117;52;6;46;42173
2020-05-24;Soria;Todos;Servicios de apoyo no sanitario;15;2;0;2;42173
2020-05-24;Valladolid;Todos;Auxiliares sanitarios;456;68;4;64;47186
2020-05-24;Valladolid;Todos;Fisioterapeuta;24;3;0;3;47186
2020-05-24;Valladolid;Todos;Otros;5;0;0;0;47186
2020-05-24;Valladolid;Todos;Técnicos sanitarios;100;9;0;9;47186
2020-05-24;Zamora;Todos;Fisioterapeuta;4;0;0;0;49275
2020-05-24;Zamora;Todos;Otros sanitarios;5;1;1;0;49275
2020-05-25;Ávila;Todos;Médicos;255;67;30;37;5019
2020-05-25;Ávila;Todos;Otros;3;1;0;1;5019
2020-05-25;Ávila;Todos;Otros sanitarios;10;5;3;2;5019
2020-05-25;Burgos;Todos;Auxiliares sanitarios;540;52;11;41;9059
2020-05-25;Burgos;Todos;Celador;130;15;2;13;9059
2020-05-25;Burgos;Todos;Enfermero/a;880;82;5;77;9059
2020-05-25;Burgos;Todos;Fisioterapeuta;18;2;0;2;9059
2020-05-25;Burgos;Todos;Médicos;446;57;7;50;9059
2020-05-25;Burgos;Todos;Personal en formación;74;5;0;5;9059
2020-05-25;León;Todos;Fisioterapeuta;35;2;0;2;24089
2020-05-25;León;Todos;Otros;6;0;0;0;24089
2020-05-25;León;Todos;Otros sanitarios;20;3;0;3;24089
2020-05-25;León;Todos;Técnicos sanitarios;188;7;1;6;24089
2020-05-25;Palencia;Todos;Auxiliares sanitarios;98;21;5;16;34120
2020-05-25;Palencia;Todos;Médicos;137;30;3;27;34120
2020-05-25;Palencia;Todos;Otros;4;1;1;0;34120
2020-05-25;Palencia;Todos;Otros sanitarios;6;1;0;1;34120
2020-05-25;Palencia;Todos;Personal en formación;26;8;2;6;34120
2020-05-25;Palencia;Todos;Técnicos sanitarios;13;3;0;3;34120
2020-05-25;Salamanca;Todos;Auxiliares sanitarios;294;81;8;73;37274
2020-05-25;Salamanca;Todos;Celador;102;23;2;21;37274
2020-05-25;Salamanca;Todos;Fisioterapeuta;13;5;1;4;37274
2020-05-25;Salamanca;Todos;Médicos;397;120;15;105;37274
2020-05-25;Salamanca;Todos;Personal en formación;100;24;6;18;37274
2020-05-25;Segovia;Todos;Administrativo;70;16;0;16;40004
2020-05-25;Segovia;Todos;Enfermero/a;345;122;2;120;40004
2020-05-25;Segovia;Todos;Otros sanitarios;6;1;1;0;40004
2020-05-25;Soria;Todos;Celador;27;9;0;9;42173
2020-05-25;Soria;Todos;Personal en formación;10;2;1;1;42173
2020-05-25;Valladolid;Todos;Auxiliares sanitarios;459;68;3;65;47186
2020-05-25;Valladolid;Todos;Personal en formación;141;22;0;22;47186
2020-05-25;Valladolid;Todos;Servicios de apoyo no sanitario;84;8;1;7;47186
2020-05-25;Zamora;Todos;Administrativo;23;1;0;1;49275
2020-05-25;Zamora;Todos;Celador;31;3;0;3;49275
2020-05-25;Zamora;Todos;Fisioterapeuta;4;0;0;0;49275
2020-05-25;Zamora;Todos;Otros sanitarios;6;1;1;0;49275
2020-05-25;Zamora;Todos;Servicios de apoyo no sanitario;5;0;0;0;49275
2020-05-26;Ávila;Todos;Administrativo;35;15;13;2;5019
2020-05-26;Ávila;Todos;Auxiliares sanitarios;228;42;25;17;5019
2020-05-26;Ávila;Todos;Celador;110;10;7;3;5019
2020-05-26;Ávila;Todos;Médicos;255;67;30;37;5019
2020-05-26;Burgos;Todos;Administrativo;102;9;0;9;9059
2020-05-26;Burgos;Todos;Auxiliares sanitarios;569;52;10;42;9059
2020-05-26;Burgos;Todos;Otros sanitarios;18;0;0;0;9059
2020-05-26;Burgos;Todos;Personal en formación;76;5;0;5;9059
2020-05-26;León;Todos;Fisioterapeuta;37;2;0;2;24089
2020-05-26;León;Todos;Otros sanitarios;20;3;0;3;24089
2020-05-26;León;Todos;Personal en formación;149;15;0;15;24089
2020-05-26;León;Todos;Servicios de apoyo no sanitario;88;4;0;4;24089
2020-05-26;León;Todos;Técnicos sanitarios;189;7;1;6;24089
2020-05-26;Palencia;Todos;Médicos;140;30;2;28;34120
2020-05-26;Palencia;Todos;Técnicos sanitarios;13;3;0;3;34120
2020-05-26;Salamanca;Todos;Administrativo;85;20;5;15;37274
2020-05-26;Salamanca;Todos;Fisioterapeuta;13;5;1;4;37274
2020-05-26;Salamanca;Todos;Personal en formación;102;24;6;18;37274
2020-05-26;Salamanca;Todos;Servicios de apoyo no sanitario;61;12;1;11;37274
2020-05-26;Salamanca;Todos;Técnicos sanitarios;50;16;1;15;37274
2020-05-26;Segovia;Todos;Auxiliares sanitarios;175;49;0;49;40004
2020-05-26;Segovia;Todos;Celador;84;21;1;20;40004
2020-05-26;Segovia;Todos;Otros;0;0;0;0;40004
2020-05-26;Soria;Todos;Celador;27;9;0;9;42173
2020-05-26;Soria;Todos;Otros sanitarios;5;2;0;2;42173
2020-05-26;Soria;Todos;Técnicos sanitarios;14;8;0;8;42173
2020-05-26;Valladolid;Todos;Otros;5;0;0;0;47186
2020-05-26;Valladolid;Todos;Servicios de apoyo no sanitario;85;8;1;7;47186
2020-05-26;Zamora;Todos;Fisioterapeuta;4;0;0;0;49275
2020-05-26;Zamora;Todos;Servicios de apoyo no sanitario;5;0;0;0;49275
2020-05-27;Ávila;Todos;Administrativo;35;15;13;2;5019
2020-05-27;Ávila;Todos;Fisioterapeuta;8;0;0;0;5019
2020-05-27;Ávila;Todos;Técnicos sanitarios;34;5;3;2;5019
2020-05-27;Burgos;Todos;Administrativo;107;9;0;9;9059
2020-05-27;Burgos;Todos;Otros;5;1;0;1;9059
2020-05-27;León;Todos;Otros;6;0;0;0;24089
2020-05-27;León;Todos;Personal en formación;154;15;0;15;24089
2020-05-27;Palencia;Todos;Enfermero/a;169;42;4;38;34120
2020-05-27;Palencia;Todos;Otros sanitarios;6;1;0;1;34120
2020-05-27;Palencia;Todos;Servicios de apoyo no sanitario;19;3;0;3;34120
2020-05-27;Palencia;Todos;Técnicos sanitarios;13;3;0;3;34120
2020-05-27;Salamanca;Todos;Enfermero/a;507;120;22;98;37274
2020-05-27;Salamanca;Todos;Fisioterapeuta;13;5;1;4;37274
2020-05-27;Salamanca;Todos;Personal en formación;103;24;6;18;37274
2020-05-27;Salamanca;Todos;Servicios de apoyo no sanitario;63;12;1;11;37274
2020-05-27;Salamanca;Todos;Técnicos sanitarios;50;16;1;15;37274
2020-05-27;Segovia;Todos;Administrativo;71;16;0;16;40004
2020-05-27;Segovia;Todos;Fisioterapeuta;4;1;0;1;40004
2020-05-27;Segovia;Todos;Médicos;251;75;8;67;40004
2020-05-27;Segovia;Todos;Servicios de apoyo no sanitario;30;10;1;9;40004
2020-05-27;Segovia;Todos;Técnicos sanitarios;34;13;0;13;40004
2020-05-27;Soria;Todos;Auxiliares sanitarios;93;26;2;24;42173
2020-05-27;Soria;Todos;Otros;0;0;0;0;42173
2020-05-27;Soria;Todos;Otros sanitarios;5;2;0;2;42173
2020-05-27;Valladolid;Todos;Celador;134;23;3;20;47186
2020-05-27;Zamora;Todos;Auxiliares sanitarios;54;5;0;5;49275
2020-05-27;Zamora;Todos;Enfermero/a;126;21;2;19;49275
2020-05-27;Zamora;Todos;Otros sanitarios;6;1;0;1;49275
2020-05-27;Zamora;Todos;Personal en formación;8;0;0;0;49275
2020-05-27;Zamora;Todos;Servicios de apoyo no sanitario;5;0;0;0;49275
2020-05-27;Zamora;Todos;Técnicos sanitarios;12;0;0;0;49275
2020-05-28;Ávila;Todos;Administrativo;35;15;13;2;5019
2020-05-28;Ávila;Todos;Celador;111;10;7;3;5019
2020-05-28;Ávila;Todos;Enfermero/a;399;85;56;29;5019
2020-05-28;Ávila;Todos;Médicos;255;67;30;37;5019
2020-05-28;Ávila;Todos;Otros;3;1;0;1;5019
2020-05-28;Ávila;Todos;Personal en formación;28;4;3;1;5019
2020-05-28;Burgos;Todos;Celador;140;15;1;14;9059
2020-05-28;Burgos;Todos;Fisioterapeuta;18;2;0;2;9059
2020-05-28;Burgos;Todos;Otros sanitarios;18;0;0;0;9059
2020-05-28;Burgos;Todos;Técnicos sanitarios;92;5;0;5;9059
2020-05-28;León;Todos;Fisioterapeuta;40;2;0;2;24089
2020-05-28;León;Todos;Servicios de apoyo no sanitario;88;4;0;4;24089
2020-05-28;Palencia;Todos;Auxiliares sanitarios;100;21;5;16;34120
2020-05-28;Palencia;Todos;Enfermero/a;169;42;4;38;34120
2020-05-28;Palencia;Todos;Fisioterapeuta;5;2;0;2;34120
2020-05-28;Palencia;Todos;Médicos;141;30;0;30;34120
2020-05-28;Palencia;Todos;Técnicos sanitarios;13;3;0;3;34120
2020-05-28;Salamanca;Todos;Auxiliares sanitarios;305;81;8;73;37274
2020-05-28;Salamanca;Todos;Enfermero/a;510;120;21;99;37274
2020-05-28;Salamanca;Todos;Fisioterapeuta;13;5;1;4;37274
2020-05-28;Salamanca;Todos;Personal en formación;103;24;6;18;37274
2020-05-28;Salamanca;Todos;Servicios de apoyo no sanitario;63;12;1;11;37274
2020-05-28;Segovia;Todos;Otros sanitarios;6;1;1;0;40004
2020-05-28;Segovia;Todos;Personal en formación;41;13;1;12;40004
2020-05-28;Soria;Todos;Otros sanitarios;5;2;0;2;42173
2020-05-28;Soria;Todos;Servicios de apoyo no sanitario;16;2;0;2;42173
2020-05-28;Soria;Todos;Técnicos sanitarios;14;8;0;8;42173
2020-05-28;Valladolid;Todos;Administrativo;167;22;1;21;47186
2020-05-28;Valladolid;Todos;Otros;6;0;0;0;47186
2020-05-28;Zamora;Todos;Otros;0;0;0;0;49275
2020-05-28;Zamora;Todos;Otros sanitarios;6;1;0;1;49275
2020-05-28;Zamora;Todos;Personal en formación;8;0;0;0;49275
2020-05-28;Zamora;Todos;Técnicos sanitarios;12;0;0;0;49275
2020-05-29;Ávila;Todos;Administrativo;35;15;13;2;5019
2020-05-29;Ávila;Todos;Enfermero/a;399;85;55;30;5019
2020-05-29;Ávila;Todos;Médicos;255;67;30;37;5019
2020-05-29;Ávila;Todos;Otros sanitarios;10;5;3;2;5019
2020-05-29;Burgos;Todos;Auxiliares sanitarios;612;52;8;44;9059
2020-05-29;Burgos;Todos;Otros sanitarios;18;0;0;0;9059
2020-05-29;León;Todos;Administrativo;178;9;1;8;24089
2020-05-29;León;Todos;Celador;296;17;2;15;24089
2020-05-29;León;Todos;Médicos;709;80;3;77;24089
2020-05-29;León;Todos;Otros;6;0;0;0;24089
2020-05-29;León;Todos;Técnicos sanitarios;212;7;1;6;24089
2020-05-29;Palencia;Todos;Administrativo;21;4;1;3;34120
2020-05-29;Palencia;Todos;Celador;40;13;0;13;34120
2020-05-29;Palencia;Todos;Fisioterapeuta;5;2;0;2;34120
2020-05-29;Palencia;Todos;Personal en formación;26;8;0;8;34120
2020-05-29;Salamanca;Todos;Enfermero/a;513;121;23;98;37274
2020-05-29;Salamanca;Todos;Otros;7;2;0;2;37274
2020-05-29;Salamanca;Todos;Servicios de apoyo no sanitario;65;12;1;11;37274
2020-05-29;Segovia;Todos;Enfermero/a;347;122;2;120;40004
2020-05-29;Segovia;Todos;Otros sanitarios;6;1;1;0;40004
2020-05-29;Soria;Todos;Otros;0;0;0;0;42173
2020-05-29;Soria;Todos;Otros sanitarios;5;2;0;2;42173
2020-05-29;Valladolid;Todos;Auxiliares sanitarios;467;68;2;66;47186
2020-05-29;Zamora;Todos;Médicos;130;20;2;18;49275
2020-05-29;Zamora;Todos;Otros sanitarios;6;1;0;1;49275
2020-05-29;Zamora;Todos;Personal en formación;8;0;0;0;49275
2020-05-29;Zamora;Todos;Servicios de apoyo no sanitario;5;0;0;0;49275
2020-05-30;Ávila;Todos;Celador;111;10;7;3;5019
2020-05-30;Ávila;Todos;Fisioterapeuta;8;0;0;0;5019
2020-05-30;Ávila;Todos;Otros sanitarios;10;5;3;2;5019
2020-05-30;Ávila;Todos;Personal en formación;28;4;3;1;5019
2020-05-30;Ávila;Todos;Servicios de apoyo no sanitario;29;8;6;2;5019
2020-05-30;Ávila;Todos;Técnicos sanitarios;34;5;3;2;5019
2020-05-30;Burgos;Todos;Médicos;516;57;7;50;9059
2020-05-30;Burgos;Todos;Personal en formación;85;5;0;5;9059
2020-05-30;Burgos;Todos;Servicios de apoyo no sanitario;48;4;0;4;9059
2020-05-30;Burgos;Todos;Técnicos sanitarios;94;5;0;5;9059
2020-05-30;León;Todos;Enfermero/a;1321;125;9;116;24089
2020-05-30;León;Todos;Médicos;709;80;3;77;24089
2020-05-30;León;Todos;Técnicos sanitarios;212;7;1;6;24089
2020-05-30;Palencia;Todos;Administrativo;21;4;1;3;34120
2020-05-30;Salamanca;Todos;Médicos;409;120;14;106;37274
2020-05-30;Salamanca;Todos;Otros sanitarios;10;4;2;2;37274
2020-05-30;Salamanca;Todos;Personal en formación;103;24;6;18;37274
2020-05-30;Segovia;Todos;Celador;85;21;1;20;40004
2020-05-30;Segovia;Todos;Fisioterapeuta;4;1;0;1;40004
2020-05-30;Segovia;Todos;Otros;0;0;0;0;40004
2020-05-30;Segovia;Todos;Otros sanitarios;6;1;1;0;40004
2020-05-30;Segovia;Todos;Técnicos sanitarios;34;13;0;13;40004
2020-05-30;Soria;Todos;Administrativo;46;14;3;11;42173
2020-05-30;Soria;Todos;Enfermero/a;172;64;10;54;42173
2020-05-30;Soria;Todos;Otros;0;0;0;0;42173
2020-05-30;Soria;Todos;Otros sanitarios;5;2;0;2;42173
2020-05-30;Soria;Todos;Personal en formación;10;2;1;1;42173
2020-05-30;Soria;Todos;Técnicos sanitarios;15;8;0;8;42173
2020-05-30;Valladolid;Todos;Otros sanitarios;21;5;1;4;47186
2020-05-30;Zamora;Todos;Fisioterapeuta;4;0;0;0;49275
2020-05-30;Zamora;Todos;Otros;0;0;0;0;49275
2020-05-30;Zamora;Todos;Otros sanitarios;6;1;0;1;49275
2020-05-30;Zamora;Todos;Personal en formación;8;0;0;0;49275
2020-05-30;Zamora;Todos;Técnicos sanitarios;13;0;0;0;49275
2020-05-31;Ávila;Todos;Auxiliares sanitarios;228;42;25;17;5019
2020-05-31;Ávila;Todos;Celador;111;10;7;3;5019
2020-05-31;Ávila;Todos;Médicos;255;67;30;37;5019
2020-05-31;Burgos;Todos;Celador;153;15;0;15;9059
2020-05-31;Burgos;Todos;Enfermero/a;1007;83;4;79;9059
2020-05-31;Burgos;Todos;Fisioterapeuta;19;2;0;2;9059
2020-05-31;Burgos;Todos;Médicos;516;57;7;50;9059
2020-05-31;Burgos;Todos;Personal en formación;85;5;0;5;9059
2020-05-31;Burgos;Todos;Servicios de apoyo no sanitario;48;4;0;4;9059
2020-05-31;León;Todos;Enfermero/a;1321;125;9;116;24089
2020-05-31;León;Todos;Médicos;709;80;3;77;24089
2020-05-31;León;Todos;Técnicos sanitarios;212;7;1;6;24089
2020-05-31;Palencia;Todos;Personal en formación;26;8;0;8;34120
2020-05-31;Palencia;Todos;Servicios de apoyo no sanitario;20;3;0;3;34120
2020-05-31;Palencia;Todos;Técnicos sanitarios;14;3;0;3;34120
2020-05-31;Salamanca;Todos;Fisioterapeuta;13;5;1;4;37274
2020-05-31;Salamanca;Todos;Otros;7;2;0;2;37274
2020-05-31;Salamanca;Todos;Personal en formación;103;24;6;18;37274
2020-05-31;Segovia;Todos;Administrativo;72;16;0;16;40004
2020-05-31;Segovia;Todos;Otros;0;0;0;0;40004
2020-05-31;Segovia;Todos;Personal en formación;41;13;1;12;40004
2020-05-31;Segovia;Todos;Técnicos sanitarios;34;13;0;13;40004
2020-05-31;Soria;Todos;Administrativo;46;14;3;11;42173
2020-05-31;Soria;Todos;Auxiliares sanitarios;96;26;2;24;42173
2020-05-31;Soria;Todos;Médicos;122;53;5;48;42173
2020-05-31;Soria;Todos;Otros sanitarios;5;2;0;2;42173
2020-05-31;Soria;Todos;Servicios de apoyo no sanitario;16;2;0;2;42173
2020-05-31;Valladolid;Todos;Administrativo;169;22;1;21;47186
2020-05-31;Valladolid;Todos;Personal en formación;142;22;0;22;47186
2020-05-31;Valladolid;Todos;Técnicos sanitarios;101;9;0;9;47186
2020-05-31;Zamora;Todos;Administrativo;23;1;0;1;49275
2020-05-31;Zamora;Todos;Fisioterapeuta;4;0;0;0;49275
2020-05-31;Zamora;Todos;Otros;0;0;0;0;49275
2020-05-31;Zamora;Todos;Personal en formación;8;0;0;0;49275
2020-06-01;Ávila;Todos;Administrativo;36;15;13;2;5019
2020-06-01;Ávila;Todos;Servicios de apoyo no sanitario;29;8;5;3;5019
2020-06-01;Burgos;Todos;Auxiliares sanitarios;643;52;8;44;9059
2020-06-01;Burgos;Todos;Enfermero/a;1061;83;4;79;9059
2020-06-01;Burgos;Todos;Médicos;540;57;7;50;9059
2020-06-01;Burgos;Todos;Otros sanitarios;18;0;0;0;9059
2020-06-01;León;Todos;Administrativo;182;9;1;8;24089
2020-06-01;León;Todos;Fisioterapeuta;41;2;0;2;24089
2020-06-01;León;Todos;Servicios de apoyo no sanitario;97;4;0;4;24089
2020-06-01;León;Todos;Técnicos sanitarios;213;7;1;6;24089
2020-06-01;Palencia;Todos;Auxiliares sanitarios;102;21;5;16;34120
2020-06-01;Palencia;Todos;Celador;40;13;0;13;34120
2020-06-01;Palencia;Todos;Enfermero/a;172;42;4;38;34120
2020-06-01;Palencia;Todos;Fisioterapeuta;5;2;0;2;34120
2020-06-01;Palencia;Todos;Personal en formación;26;8;0;8;34120
2020-06-01;Salamanca;Todos;Enfermero/a;515;121;23;98;37274
2020-06-01;Salamanca;Todos;Fisioterapeuta;13;5;1;4;37274
2020-06-01;Salamanca;Todos;Médicos;409;120;14;106;37274
2020-06-01;Salamanca;Todos;Otros sanitarios;10;4;2;2;37274
2020-06-01;Salamanca;Todos;Servicios de apoyo no sanitario;66;12;1;11;37274
2020-06-01;Segovia;Todos;Administrativo;72;16;0;16;40004
2020-06-01;Segovia;Todos;Auxiliares sanitarios;176;49;0;49;40004
2020-06-01;Soria;Todos;Administrativo;46;14;3;11;42173
2020-06-01;Soria;Todos;Celador;27;9;0;9;42173
2020-06-01;Soria;Todos;Enfermero/a;173;65;11;54;42173
2020-06-01;Soria;Todos;Fisioterapeuta;4;1;0;1;42173
2020-06-01;Soria;Todos;Médicos;122;53;5;48;42173
2020-06-01;Soria;Todos;Otros;0;0;0;0;42173
2020-06-01;Soria;Todos;Personal en formación;10;2;1;1;42173
2020-06-01;Valladolid;Todos;Médicos;663;100;1;99;47186
2020-06-01;Valladolid;Todos;Técnicos sanitarios;103;9;0;9;47186
2020-06-01;Zamora;Todos;Administrativo;23;1;0;1;49275
2020-06-01;Zamora;Todos;Celador;31;3;0;3;49275
2020-06-01;Zamora;Todos;Técnicos sanitarios;13;0;0;0;49275
2020-06-02;Ávila;Todos;Celador;110;9;5;4;5019
2020-06-02;Ávila;Todos;Fisioterapeuta;8;0;0;0;5019
2020-06-02;Ávila;Todos;Personal en formación;28;4;3;1;5019
2020-06-02;Burgos;Todos;Celador;164;15;1;14;9059
2020-06-02;Burgos;Todos;Servicios de apoyo no sanitario;50;4;0;4;9059
2020-06-02;Burgos;Todos;Técnicos sanitarios;99;5;0;5;9059
2020-06-02;León;Todos;Celador;298;17;1;16;24089
2020-06-02;León;Todos;Médicos;744;81;4;77;24089
2020-06-02;León;Todos;Otros;7;0;0;0;24089
2020-06-02;León;Todos;Técnicos sanitarios;215;7;1;6;24089
2020-06-02;Palencia;Todos;Celador;41;13;0;13;34120
2020-06-02;Palencia;Todos;Personal en formación;26;8;0;8;34120
2020-06-02;Palencia;Todos;Técnicos sanitarios;15;3;0;3;34120
2020-06-02;Salamanca;Todos;Celador;107;23;2;21;37274
2020-06-02;Salamanca;Todos;Enfermero/a;525;121;21;100;37274
2020-06-02;Salamanca;Todos;Personal en formación;103;24;6;18;37274
2020-06-02;Segovia;Todos;Celador;86;21;1;20;40004
2020-06-02;Segovia;Todos;Otros sanitarios;6;1;1;0;40004
2020-06-02;Segovia;Todos;Servicios de apoyo no sanitario;31;10;0;10;40004
2020-06-02;Segovia;Todos;Técnicos sanitarios;34;13;0;13;40004
2020-06-02;Soria;Todos;Administrativo;47;14;4;10;42173
2020-06-02;Soria;Todos;Auxiliares sanitarios;96;26;1;25;42173
2020-06-02;Soria;Todos;Fisioterapeuta;4;1;0;1;42173
2020-06-02;Soria;Todos;Otros;0;0;0;0;42173
2020-06-02;Soria;Todos;Personal en formación;10;2;1;1;42173
2020-06-02;Valladolid;Todos;Otros sanitarios;21;5;1;4;47186
2020-06-02;Valladolid;Todos;Personal en formación;142;22;0;22;47186
2020-06-02;Valladolid;Todos;Servicios de apoyo no sanitario;90;8;1;7;47186
2020-06-02;Zamora;Todos;Auxiliares sanitarios;55;5;0;5;49275
2020-06-03;Ávila;Todos;Celador;110;9;5;4;5019
2020-06-03;Ávila;Todos;Enfermero/a;399;83;51;32;5019
2020-06-03;Ávila;Todos;Fisioterapeuta;8;0;0;0;5019
2020-06-03;Ávila;Todos;Otros;3;1;0;1;5019
2020-06-03;Ávila;Todos;Técnicos sanitarios;35;5;3;2;5019
2020-06-03;Burgos;Todos;Administrativo;113;9;0;9;9059
2020-06-03;Burgos;Todos;Médicos;661;58;7;51;9059
2020-06-03;Burgos;Todos;Otros;5;1;0;1;9059
2020-06-03;Burgos;Todos;Otros sanitarios;20;0;0;0;9059
2020-06-03;Burgos;Todos;Personal en formación;125;5;0;5;9059
2020-06-03;León;Todos;Personal en formación;171;15;0;15;24089
2020-06-03;Palencia;Todos;Fisioterapeuta;5;2;0;2;34120
2020-06-03;Salamanca;Todos;Administrativo;92;20;4;16;37274
2020-06-03;Salamanca;Todos;Servicios de apoyo no sanitario;68;12;1;11;37274
2020-06-03;Segovia;Todos;Administrativo;73;16;0;16;40004
2020-06-03;Segovia;Todos;Enfermero/a;350;122;2;120;40004
2020-06-03;Segovia;Todos;Otros sanitarios;6;1;1;0;40004
2020-06-03;Segovia;Todos;Servicios de apoyo no sanitario;31;10;0;10;40004
2020-06-03;Segovia;Todos;Técnicos sanitarios;34;13;0;13;40004
2020-06-03;Soria;Todos;Auxiliares sanitarios;96;26;1;25;42173
2020-06-03;Soria;Todos;Médicos;125;53;5;48;42173
2020-06-03;Soria;Todos;Otros;0;0;0;0;42173
2020-06-03;Soria;Todos;Servicios de apoyo no sanitario;17;3;1;2;42173
2020-06-03;Soria;Todos;Técnicos sanitarios;15;8;0;8;42173
2020-06-03;Valladolid;Todos;Fisioterapeuta;25;3;0;3;47186
2020-06-03;Valladolid;Todos;Médicos;664;100;1;99;47186
2020-06-03;Valladolid;Todos;Otros;6;0;0;0;47186
2020-06-03;Valladolid;Todos;Otros sanitarios;21;5;0;5;47186
2020-06-03;Zamora;Todos;Administrativo;23;1;0;1;49275
2020-06-03;Zamora;Todos;Celador;31;3;0;3;49275
2020-06-03;Zamora;Todos;Técnicos sanitarios;13;0;0;0;49275
2020-06-04;Ávila;Todos;Celador;110;9;5;4;5019
2020-06-04;Ávila;Todos;Enfermero/a;400;83;51;32;5019
2020-06-04;Ávila;Todos;Médicos;257;67;30;37;5019
2020-06-04;Ávila;Todos;Personal en formación;28;4;3;1;5019
2020-06-04;Ávila;Todos;Servicios de apoyo no sanitario;29;8;5;3;5019
2020-06-04;Burgos;Todos;Administrativo;115;9;0;9;9059
2020-06-04;Burgos;Todos;Servicios de apoyo no sanitario;50;4;0;4;9059
2020-06-04;León;Todos;Administrativo;295;9;1;8;24089
2020-06-04;León;Todos;Auxiliares sanitarios;896;60;4;56;24089
2020-06-04;León;Todos;Enfermero/a;1460;126;9;117;24089
2020-06-04;León;Todos;Médicos;832;81;4;77;24089
2020-06-04;León;Todos;Otros;8;0;0;0;24089
2020-06-04;León;Todos;Personal en formación;171;15;0;15;24089
2020-06-04;León;Todos;Servicios de apoyo no sanitario;139;4;0;4;24089
2020-06-04;Palencia;Todos;Administrativo;22;4;1;3;34120
2020-06-04;Palencia;Todos;Celador;41;13;0;13;34120
2020-06-04;Palencia;Todos;Fisioterapeuta;5;2;0;2;34120
2020-06-04;Palencia;Todos;Personal en formación;26;8;0;8;34120
2020-06-04;Salamanca;Todos;Auxiliares sanitarios;315;82;10;72;37274
2020-06-04;Salamanca;Todos;Celador;109;23;2;21;37274
2020-06-04;Salamanca;Todos;Médicos;410;119;13;106;37274
2020-06-04;Salamanca;Todos;Otros;7;2;0;2;37274
2020-06-04;Salamanca;Todos;Otros sanitarios;10;4;2;2;37274
2020-06-04;Salamanca;Todos;Servicios de apoyo no sanitario;68;12;1;11;37274
2020-06-04;Segovia;Todos;Administrativo;72;16;0;16;40004
2020-06-04;Segovia;Todos;Auxiliares sanitarios;176;49;0;49;40004
2020-06-04;Segovia;Todos;Enfermero/a;352;122;2;120;40004
2020-06-04;Segovia;Todos;Médicos;253;75;8;67;40004
2020-06-04;Segovia;Todos;Otros sanitarios;6;1;1;0;40004
2020-06-04;Segovia;Todos;Personal en formación;43;13;1;12;40004
2020-06-04;Segovia;Todos;Servicios de apoyo no sanitario;32;10;0;10;40004
2020-06-04;Soria;Todos;Auxiliares sanitarios;97;26;1;25;42173
2020-06-04;Soria;Todos;Celador;27;9;0;9;42173
2020-06-04;Soria;Todos;Fisioterapeuta;4;1;0;1;42173
2020-06-04;Valladolid;Todos;Celador;137;23;3;20;47186
2020-06-04;Valladolid;Todos;Enfermero/a;986;153;6;147;47186
2020-06-04;Valladolid;Todos;Fisioterapeuta;25;3;0;3;47186
2020-06-04;Valladolid;Todos;Personal en formación;144;22;0;22;47186
2020-06-04;Valladolid;Todos;Servicios de apoyo no sanitario;91;8;1;7;47186
2020-06-04;Zamora;Todos;Otros sanitarios;6;1;0;1;49275
2020-06-04;Zamora;Todos;Técnicos sanitarios;13;0;0;0;49275
2020-06-05;Ávila;Todos;Administrativo;36;15;13;2;5019
2020-06-05;Ávila;Todos;Otros;3;1;0;1;5019
2020-06-05;Ávila;Todos;Otros sanitarios;10;5;3;2;5019
2020-06-05;Burgos;Todos;Administrativo;115;9;0;9;9059
2020-06-05;Burgos;Todos;Celador;226;15;1;14;9059
2020-06-05;Burgos;Todos;Enfermero/a;1231;84;1;83;9059
2020-06-05;Burgos;Todos;Servicios de apoyo no sanitario;76;4;0;4;9059
2020-06-05;León;Todos;Celador;373;17;1;16;24089
2020-06-05;León;Todos;Enfermero/a;1494;126;7;119;24089
2020-06-05;León;Todos;Otros sanitarios;27;3;0;3;24089
2020-06-05;León;Todos;Personal en formación;171;15;0;15;24089
2020-06-05;León;Todos;Técnicos sanitarios;220;7;0;7;24089
2020-06-05;Palencia;Todos;Fisioterapeuta;5;2;0;2;34120
2020-06-05;Palencia;Todos;Otros;4;1;1;0;34120
2020-06-05;Palencia;Todos;Servicios de apoyo no sanitario;21;4;1;3;34120
2020-06-05;Salamanca;Todos;Administrativo;92;20;3;17;37274
2020-06-05;Salamanca;Todos;Fisioterapeuta;13;5;0;5;37274
2020-06-05;Salamanca;Todos;Otros sanitarios;10;4;2;2;37274
2020-06-05;Salamanca;Todos;Técnicos sanitarios;53;16;1;15;37274
2020-06-05;Segovia;Todos;Auxiliares sanitarios;176;49;0;49;40004
2020-06-05;Segovia;Todos;Celador;86;21;1;20;40004
2020-06-05;Segovia;Todos;Fisioterapeuta;4;1;0;1;40004
2020-06-05;Segovia;Todos;Médicos;253;75;8;67;40004
2020-06-05;Segovia;Todos;Otros;0;0;0;0;40004
2020-06-05;Soria;Todos;Auxiliares sanitarios;97;26;1;25;42173
2020-06-05;Soria;Todos;Celador;28;9;0;9;42173
2020-06-05;Soria;Todos;Servicios de apoyo no sanitario;18;3;1;2;42173
2020-06-05;Valladolid;Todos;Fisioterapeuta;25;3;0;3;47186
2020-06-05;Valladolid;Todos;Otros sanitarios;21;5;0;5;47186
2020-06-05;Valladolid;Todos;Personal en formación;145;22;0;22;47186
2020-06-05;Valladolid;Todos;Servicios de apoyo no sanitario;91;8;1;7;47186
2020-06-05;Zamora;Todos;Administrativo;23;1;0;1;49275
2020-06-05;Zamora;Todos;Auxiliares sanitarios;57;5;0;5;49275
2020-06-05;Zamora;Todos;Otros sanitarios;6;1;0;1;49275
2020-06-05;Zamora;Todos;Personal en formación;8;0;0;0;49275
2020-06-06;Ávila;Todos;Administrativo;36;15;13;2;5019
2020-06-06;Ávila;Todos;Auxiliares sanitarios;227;42;23;19;5019
2020-06-06;Ávila;Todos;Celador;111;9;5;4;5019
2020-06-06;Ávila;Todos;Médicos;258;67;30;37;5019
2020-06-06;Ávila;Todos;Servicios de apoyo no sanitario;29;8;5;3;5019
2020-06-06;Burgos;Todos;Auxiliares sanitarios;779;51;2;49;9059
2020-06-06;Burgos;Todos;Otros sanitarios;20;0;0;0;9059
2020-06-06;Burgos;Todos;Técnicos sanitarios;129;5;0;5;9059
2020-06-06;León;Todos;Otros sanitarios;28;3;0;3;24089
2020-06-06;León;Todos;Técnicos sanitarios;221;7;0;7;24089
2020-06-06;Palencia;Todos;Auxiliares sanitarios;105;21;2;19;34120
2020-06-06;Palencia;Todos;Celador;41;13;0;13;34120
2020-06-06;Palencia;Todos;Médicos;147;31;1;30;34120
2020-06-06;Palencia;Todos;Otros;4;1;1;0;34120
2020-06-06;Palencia;Todos;Personal en formación;27;8;0;8;34120
2020-06-06;Palencia;Todos;Técnicos sanitarios;15;3;0;3;34120
2020-06-06;Salamanca;Todos;Auxiliares sanitarios;316;82;10;72;37274
2020-06-06;Salamanca;Todos;Técnicos sanitarios;53;16;1;15;37274
2020-06-06;Segovia;Todos;Administrativo;72;16;0;16;40004
2020-06-06;Segovia;Todos;Otros;0;0;0;0;40004
2020-06-06;Segovia;Todos;Personal en formación;43;13;1;12;40004
2020-06-06;Segovia;Todos;Servicios de apoyo no sanitario;32;10;0;10;40004
2020-06-06;Soria;Todos;Auxiliares sanitarios;97;26;1;25;42173
2020-06-06;Soria;Todos;Fisioterapeuta;4;1;0;1;42173
2020-06-06;Soria;Todos;Personal en formación;10;2;1;1;42173
2020-06-06;Soria;Todos;Técnicos sanitarios;15;8;0;8;42173
2020-06-06;Valladolid;Todos;Enfermero/a;991;153;5;148;47186
2020-06-06;Valladolid;Todos;Técnicos sanitarios;105;9;0;9;47186
2020-06-06;Zamora;Todos;Enfermero/a;131;21;2;19;49275
2020-06-06;Zamora;Todos;Fisioterapeuta;4;0;0;0;49275
2020-06-06;Zamora;Todos;Otros sanitarios;6;1;0;1;49275
2020-06-07;Ávila;Todos;Otros;3;1;0;1;5019
2020-06-07;Ávila;Todos;Otros sanitarios;10;5;3;2;5019
2020-06-07;Burgos;Todos;Otros sanitarios;20;0;0;0;9059
2020-06-07;León;Todos;Administrativo;317;9;1;8;24089
2020-06-07;León;Todos;Celador;374;17;1;16;24089
2020-06-07;León;Todos;Fisioterapeuta;44;2;0;2;24089
2020-06-07;León;Todos;Otros;8;0;0;0;24089
2020-06-07;León;Todos;Otros sanitarios;28;3;0;3;24089
2020-06-07;León;Todos;Personal en formación;171;15;0;15;24089
2020-06-07;Palencia;Todos;Administrativo;22;4;1;3;34120
2020-06-07;Palencia;Todos;Auxiliares sanitarios;105;21;2;19;34120
2020-06-07;Palencia;Todos;Celador;41;13;0;13;34120
2020-06-07;Palencia;Todos;Fisioterapeuta;5;2;0;2;34120
2020-06-07;Palencia;Todos;Médicos;147;31;1;30;34120
2020-06-07;Palencia;Todos;Otros sanitarios;6;1;0;1;34120
2020-06-07;Palencia;Todos;Servicios de apoyo no sanitario;21;4;1;3;34120
2020-06-07;Palencia;Todos;Técnicos sanitarios;15;3;0;3;34120
2020-06-07;Salamanca;Todos;Médicos;413;120;13;107;37274
2020-06-07;Salamanca;Todos;Otros sanitarios;10;4;2;2;37274
2020-06-07;Salamanca;Todos;Servicios de apoyo no sanitario;70;12;1;11;37274
2020-06-07;Segovia;Todos;Auxiliares sanitarios;176;49;0;49;40004
2020-06-07;Segovia;Todos;Personal en formación;43;13;1;12;40004
2020-06-07;Soria;Todos;Fisioterapeuta;4;1;0;1;42173
2020-06-07;Soria;Todos;Personal en formación;10;2;1;1;42173
2020-06-07;Soria;Todos;Técnicos sanitarios;15;8;1;7;42173
2020-06-07;Valladolid;Todos;Administrativo;170;22;1;21;47186
2020-06-07;Valladolid;Todos;Enfermero/a;993;153;5;148;47186
2020-06-07;Valladolid;Todos;Otros;6;0;0;0;47186
2020-06-07;Valladolid;Todos;Otros sanitarios;21;5;0;5;47186
2020-06-07;Valladolid;Todos;Personal en formación;145;22;0;22;47186
2020-06-07;Valladolid;Todos;Técnicos sanitarios;105;9;0;9;47186
2020-06-07;Zamora;Todos;Administrativo;23;1;0;1;49275
2020-06-07;Zamora;Todos;Enfermero/a;131;21;2;19;49275
2020-06-07;Zamora;Todos;Servicios de apoyo no sanitario;5;0;0;0;49275
2020-06-07;Zamora;Todos;Técnicos sanitarios;14;0;0;0;49275
2020-06-08;Ávila;Emergencias sanitarias;Administrativo;0;0;0;0;5019
2020-06-08;Ávila;Emergencias sanitarias;Celador;0;0;0;0;5019
2020-06-08;Ávila;Emergencias sanitarias;Enfermero/a;0;0;0;0;5019
2020-06-08;Ávila;Emergencias sanitarias;Fisioterapeuta;0;0;0;0;5019
2020-06-08;Ávila;Emergencias sanitarias;Técnicos sanitarios;0;0;0;0;5019
2020-06-08;Ávila;Especializada;Otros;3;1;0;1;5019
2020-06-08;Ávila;Especializada;Técnicos sanitarios;35;17;3;14;5019
2020-06-08;Ávila;Primaria;Fisioterapeuta;2;0;0;0;5019
2020-06-08;Ávila;Servicios centrales GRS;Administrativo;0;0;0;0;5019
2020-06-08;Ávila;Servicios centrales GRS;Auxiliares sanitarios;0;0;0;0;5019
2020-06-08;Ávila;Servicios centrales GRS;Enfermero/a;0;0;0;0;5019
2020-06-08;Ávila;Servicios centrales GRS;Fisioterapeuta;0;0;0;0;5019
2020-06-08;Burgos;Emergencias sanitarias;Auxiliares sanitarios;0;0;0;0;9059
2020-06-08;Burgos;Emergencias sanitarias;Celador;0;0;0;0;9059
2020-06-08;Burgos;Emergencias sanitarias;Fisioterapeuta;0;0;0;0;9059
2020-06-08;Burgos;Emergencias sanitarias;Médicos;0;0;0;0;9059
2020-06-08;Burgos;Emergencias sanitarias;Otros;0;0;0;0;9059
2020-06-08;Burgos;Emergencias sanitarias;Otros sanitarios;0;0;0;0;9059
2020-06-08;Burgos;Especializada;Auxiliares sanitarios;806;131;1;130;9059
2020-06-08;Burgos;Especializada;Personal en formación;140;16;1;15;9059
2020-06-08;Burgos;Especializada;Servicios de apoyo no sanitarios;75;13;0;13;9059
2020-06-08;Burgos;Primaria;Administrativo;28;7;0;7;9059
2020-06-08;Burgos;Primaria;Auxiliares sanitarios;9;2;1;1;9059
2020-06-08;Burgos;Primaria;Otros sanitarios;6;1;0;1;9059
2020-06-08;Burgos;Primaria;Técnicos sanitarios;5;0;0;0;9059
2020-06-08;Burgos;Servicios centrales GRS;Otros;0;0;0;0;9059
2020-06-08;Burgos;Servicios centrales GRS;Personal en formación;0;0;0;0;9059
2020-06-08;Burgos;Servicios centrales GRS;Servicios de apoyo no sanitarios;0;0;0;0;9059
2020-06-08;León;Emergencias sanitarias;Celador;0;0;0;0;24089
2020-06-08;León;Emergencias sanitarias;Enfermero/a;0;0;0;0;24089
2020-06-08;León;Emergencias sanitarias;Servicios de apoyo no sanitarios;0;0;0;0;24089
2020-06-08;León;Especializada;Personal en formación;147;13;0;13;24089
2020-06-08;León;Primaria;Administrativo;67;11;0;11;24089
2020-06-08;León;Primaria;Celador;25;3;0;3;24089
2020-06-08;León;Primaria;Otros;1;0;0;0;24089
2020-06-08;León;Primaria;Personal en formación;30;11;0;11;24089
2020-06-08;León;Primaria;Servicios de apoyo no sanitarios;7;0;0;0;24089
2020-06-08;León;Servicios centrales GRS;Auxiliares sanitarios;0;0;0;0;24089
2020-06-08;León;Servicios centrales GRS;Fisioterapeuta;0;0;0;0;24089
2020-06-08;León;Servicios centrales GRS;Otros;0;0;0;0;24089
2020-06-08;Palencia;Emergencias sanitarias;Administrativo;0;0;0;0;34120
2020-06-08;Palencia;Emergencias sanitarias;Celador;0;0;0;0;34120
2020-06-08;Palencia;Emergencias sanitarias;Otros;0;0;0;0;34120
2020-06-08;Palencia;Emergencias sanitarias;Servicios de apoyo no sanitarios;0;0;0;0;34120
2020-06-08;Palencia;Emergencias sanitarias;Técnicos sanitarios;0;0;0;0;34120
2020-06-08;Palencia;Especializada;Celador;35;13;0;13;34120
2020-06-08;Palencia;Especializada;Médicos;82;20;1;19;34120
2020-06-08;Palencia;Especializada;Otros sanitarios;3;1;0;1;34120
2020-06-08;Palencia;Especializada;Servicios de apoyo no sanitarios;19;4;0;4;34120
2020-06-08;Palencia;Primaria;Celador;6;3;0;3;34120
2020-06-08;Palencia;Primaria;Fisioterapeuta;3;2;0;2;34120
2020-06-08;Palencia;Primaria;Otros sanitarios;3;1;0;1;34120
2020-06-08;Palencia;Primaria;Personal en formación;17;5;0;5;34120
2020-06-08;Palencia;Servicios centrales GRS;Otros;0;0;0;0;34120
2020-06-08;Salamanca;Emergencias sanitarias;Enfermero/a;0;0;0;0;37274
2020-06-08;Salamanca;Emergencias sanitarias;Personal en formación;0;0;0;0;37274
2020-06-08;Salamanca;Emergencias sanitarias;Técnicos sanitarios;0;0;0;0;37274
2020-06-08;Salamanca;Especializada;Auxiliares sanitarios;313;93;10;83;37274
2020-06-08;Salamanca;Especializada;Celador;103;24;3;21;37274
2020-06-08;Salamanca;Especializada;Enfermero/a;421;116;19;97;37274
2020-06-08;Salamanca;Especializada;Médicos;264;84;8;76;37274
2020-06-08;Salamanca;Primaria;Médicos;150;62;5;57;37274
2020-06-08;Salamanca;Primaria;Otros;2;1;0;1;37274
2020-06-08;Salamanca;Primaria;Personal en formación;14;3;1;2;37274
2020-06-08;Salamanca;Primaria;Servicios de apoyo no sanitarios;1;1;0;1;37274
2020-06-08;Salamanca;Servicios centrales GRS;Médicos;0;0;0;0;37274
2020-06-08;Segovia;Emergencias sanitarias;Auxiliares sanitarios;0;0;0;0;40004
2020-06-08;Segovia;Emergencias sanitarias;Enfermero/a;0;0;0;0;40004
2020-06-08;Segovia;Emergencias sanitarias;Fisioterapeuta;0;0;0;0;40004
2020-06-08;Segovia;Emergencias sanitarias;Médicos;0;0;0;0;40004
2020-06-08;Segovia;Especializada;Administrativo;46;19;0;19;40004
2020-06-08;Segovia;Especializada;Celador;81;41;1;40;40004
2020-06-08;Segovia;Especializada;Enfermero/a;259;107;2;105;40004
2020-06-08;Segovia;Especializada;Otros sanitarios;3;2;1;1;40004
2020-06-08;Segovia;Primaria;Otros;0;0;0;0;40004
2020-06-08;Segovia;Primaria;Otros sanitarios;3;2;0;2;40004
2020-06-08;Segovia;Servicios centrales GRS;Administrativo;0;0;0;0;40004
2020-06-08;Segovia;Servicios centrales GRS;Fisioterapeuta;0;0;0;0;40004
2020-06-08;Segovia;Servicios centrales GRS;Otros sanitarios;0;0;0;0;40004
2020-06-08;Segovia;Servicios centrales GRS;Servicios de apoyo no sanitarios;0;0;0;0;40004
2020-06-08;Soria;Emergencias sanitarias;Servicios de apoyo no sanitarios;0;0;0;0;42173
2020-06-08;Soria;Emergencias sanitarias;Técnicos sanitarios;0;0;0;0;42173
2020-06-08;Soria;Especializada;Celador;27;13;0;13;42173
2020-06-08;Soria;Especializada;Enfermero/a;132;85;7;78;42173
2020-06-08;Soria;Especializada;Fisioterapeuta;1;1;0;1;42173
2020-06-08;Soria;Especializada;Otros;0;0;0;0;42173
2020-06-08;Soria;Especializada;Servicios de apoyo no sanitarios;16;14;1;13;42173
2020-06-08;Soria;Primaria;Administrativo;21;18;2;16;42173
2020-06-08;Soria;Primaria;Auxiliares sanitarios;2;1;0;1;42173
2020-06-08;Soria;Primaria;Personal en formación;7;3;1;2;42173
2020-06-08;Soria;Primaria;Servicios de apoyo no sanitarios;2;1;0;1;42173
2020-06-08;Soria;Servicios centrales GRS;Celador;0;0;0;0;42173
2020-06-08;Soria;Servicios centrales GRS;Fisioterapeuta;0;0;0;0;42173
2020-06-08;Soria;Servicios centrales GRS;Otros;0;0;0;0;42173
2020-06-08;Soria;Servicios centrales GRS;Técnicos sanitarios;0;0;0;0;42173
2020-06-08;Valladolid;Emergencias sanitarias;Auxiliares sanitarios;0;0;0;0;47186
2020-06-08;Valladolid;Emergencias sanitarias;Enfermero/a;57;14;1;13;47186
2020-06-08;Valladolid;Emergencias sanitarias;Fisioterapeuta;0;0;0;0;47186
2020-06-08;Valladolid;Emergencias sanitarias;Otros sanitarios;2;2;0;2;47186
2020-06-08;Valladolid;Especializada;Enfermero/a;797;212;4;208;47186
2020-06-08;Valladolid;Especializada;Fisioterapeuta;17;1;0;1;47186
2020-06-08;Valladolid;Especializada;Otros sanitarios;11;6;0;6;47186
2020-06-08;Valladolid;Especializada;Servicios de apoyo no sanitarios;83;37;1;36;47186
2020-06-08;Valladolid;Primaria;Auxiliares sanitarios;13;4;0;4;47186
2020-06-08;Valladolid;Primaria;Celador;5;2;0;2;47186
2020-06-08;Valladolid;Primaria;Personal en formación;29;5;0;5;47186
2020-06-08;Valladolid;Servicios centrales GRS;Auxiliares sanitarios;2;0;0;0;47186
2020-06-08;Valladolid;Servicios centrales GRS;Celador;0;0;0;0;47186
2020-06-08;Valladolid;Servicios centrales GRS;Fisioterapeuta;1;1;0;1;47186
2020-06-08;Valladolid;Servicios centrales GRS;Otros sanitarios;1;0;0;0;47186
2020-06-08;Valladolid;Servicios centrales GRS;Servicios de apoyo no sanitarios;5;3;0;3;47186
2020-06-08;Valladolid;Servicios centrales GRS;Técnicos sanitarios;23;4;0;4;47186
2020-06-08;Zamora;Emergencias sanitarias;Enfermero/a;0;0;0;0;49275
2020-06-08;Zamora;Emergencias sanitarias;Médicos;0;0;0;0;49275
2020-06-08;Zamora;Emergencias sanitarias;Otros;0;0;0;0;49275
2020-06-08;Zamora;Emergencias sanitarias;Otros sanitarios;0;0;0;0;49275
2020-06-08;Zamora;Emergencias sanitarias;Personal en formación;0;0;0;0;49275
2020-06-08;Zamora;Emergencias sanitarias;Servicios de apoyo no sanitarios;0;0;0;0;49275
2020-06-08;Zamora;Especializada;Celador;28;17;0;17;49275
2020-06-08;Zamora;Especializada;Médicos;73;26;1;25;49275
2020-06-08;Zamora;Especializada;Otros;0;0;0;0;49275
2020-06-08;Zamora;Especializada;Personal en formación;5;2;0;2;49275
2020-06-08;Zamora;Especializada;Servicios de apoyo no sanitarios;4;1;0;1;49275
2020-06-08;Zamora;Primaria;Administrativo;8;5;0;5;49275
2020-06-08;Zamora;Primaria;Servicios de apoyo no sanitarios;1;1;0;1;49275
2020-06-08;Zamora;Servicios centrales GRS;Auxiliares sanitarios;0;0;0;0;49275
2020-06-08;Zamora;Servicios centrales GRS;Fisioterapeuta;0;0;0;0;49275
2020-06-08;Zamora;Servicios centrales GRS;Médicos;0;0;0;0;49275
2020-06-08;Zamora;Servicios centrales GRS;Otros;0;0;0;0;49275
2020-04-05;Ávila;Todos;Administrativo;16;13;13;0;5019
2020-04-05;Ávila;Todos;Fisioterapeuta;2;0;0;0;5019
2020-04-05;Ávila;Todos;Servicios de apoyo no sanitario;18;8;8;0;5019
2020-04-05;Burgos;Todos;Auxiliares sanitarios;90;29;28;1;9059
2020-04-05;Burgos;Todos;Enfermero/a;178;51;44;7;9059
2020-04-05;Burgos;Todos;Otros;0;0;0;0;9059
2020-04-05;León;Todos;Auxiliares sanitarios;67;26;24;2;24089
2020-04-05;León;Todos;Otros sanitarios;7;1;1;0;24089
2020-04-05;Palencia;Todos;Fisioterapeuta;0;0;0;0;34120
2020-04-05;Palencia;Todos;Otros;1;0;0;0;34120
2020-04-05;Salamanca;Todos;Celador;40;14;14;0;37274
2020-04-05;Salamanca;Todos;Enfermero/a;234;89;85;4;37274
2020-04-05;Salamanca;Todos;Fisioterapeuta;6;4;4;0;37274
2020-04-05;Salamanca;Todos;Personal en formación;38;15;14;1;37274
2020-04-05;Segovia;Todos;Otros;0;0;0;0;40004
2020-04-05;Segovia;Todos;Personal en formación;18;9;9;0;40004
2020-04-05;Segovia;Todos;Técnicos sanitarios;22;13;13;0;40004
2020-04-05;Soria;Todos;Médicos;78;48;38;10;42173
2020-04-05;Soria;Todos;Otros sanitarios;2;1;1;0;42173
2020-04-05;Soria;Todos;Servicios de apoyo no sanitario;2;2;2;0;42173
2020-04-05;Valladolid;Todos;Fisioterapeuta;5;1;1;0;47186
2020-04-05;Valladolid;Todos;Otros;0;0;0;0;47186
2020-04-05;Valladolid;Todos;Personal en formación;62;13;9;4;47186
2020-04-05;Zamora;Todos;Fisioterapeuta;0;0;0;0;49275
2020-04-05;Zamora;Todos;Otros;0;0;0;0;49275
2020-04-06;Ávila;Todos;Médicos;142;64;61;3;5019
2020-04-06;Ávila;Todos;Otros;1;1;1;0;5019
2020-04-06;Ávila;Todos;Otros sanitarios;8;5;5;0;5019
2020-04-06;Burgos;Todos;Celador;18;7;7;0;9059
2020-04-06;Burgos;Todos;Otros sanitarios;2;0;0;0;9059
2020-04-06;Burgos;Todos;Servicios de apoyo no sanitario;3;1;0;1;9059
2020-04-06;León;Todos;Administrativo;24;4;4;0;24089
2020-04-06;León;Todos;Auxiliares sanitarios;76;30;27;3;24089
2020-04-06;León;Todos;Fisioterapeuta;4;2;1;1;24089
2020-04-06;León;Todos;Médicos;218;68;50;18;24089
2020-04-06;León;Todos;Personal en formación;38;14;13;1;24089
2020-04-06;Palencia;Todos;Administrativo;7;3;3;0;34120
2020-04-06;Palencia;Todos;Fisioterapeuta;0;0;0;0;34120
2020-04-06;Palencia;Todos;Servicios de apoyo no sanitario;3;2;2;0;34120
2020-04-06;Salamanca;Todos;Administrativo;27;13;12;1;37274
2020-04-06;Salamanca;Todos;Auxiliares sanitarios;122;52;51;1;37274
2020-04-06;Salamanca;Todos;Personal en formación;39;15;12;3;37274
2020-04-06;Salamanca;Todos;Técnicos sanitarios;32;14;14;0;37274
2020-04-06;Segovia;Todos;Auxiliares sanitarios;72;37;37;0;40004
2020-04-06;Segovia;Todos;Celador;25;16;15;1;40004
2020-04-06;Segovia;Todos;Enfermero/a;197;110;99;11;40004
2020-04-06;Segovia;Todos;Médicos;152;68;55;13;40004
2020-04-06;Segovia;Todos;Otros;0;0;0;0;40004
2020-04-06;Segovia;Todos;Otros sanitarios;2;1;1;0;40004
2020-04-06;Segovia;Todos;Técnicos sanitarios;22;13;13;0;40004
2020-04-06;Soria;Todos;Enfermero/a;89;54;42;12;42173
2020-04-06;Soria;Todos;Fisioterapeuta;2;1;1;0;42173
2020-04-06;Soria;Todos;Médicos;78;48;38;10;42173
2020-04-06;Soria;Todos;Otros;0;0;0;0;42173
2020-04-06;Valladolid;Todos;Enfermero/a;335;106;100;6;47186
2020-04-06;Valladolid;Todos;Personal en formación;69;16;12;4;47186
2020-04-06;Valladolid;Todos;Servicios de apoyo no sanitario;23;7;7;0;47186
2020-04-06;Zamora;Todos;Administrativo;4;1;0;1;49275
2020-04-06;Zamora;Todos;Médicos;60;17;10;7;49275
2020-04-06;Zamora;Todos;Otros sanitarios;2;1;1;0;49275
2020-04-06;Zamora;Todos;Personal en formación;1;0;0;0;49275
2020-04-07;Ávila;Todos;Administrativo;16;13;13;0;5019
2020-04-07;Ávila;Todos;Enfermero/a;156;70;69;1;5019
2020-04-07;Ávila;Todos;Personal en formación;10;4;4;0;5019
2020-04-07;Burgos;Todos;Fisioterapeuta;3;1;0;1;9059
2020-04-07;Burgos;Todos;Servicios de apoyo no sanitario;3;1;0;1;9059
2020-04-07;Burgos;Todos;Técnicos sanitarios;12;4;1;3;9059
2020-04-07;León;Todos;Administrativo;25;4;3;1;24089
2020-04-07;León;Todos;Celador;28;9;8;1;24089
2020-04-07;León;Todos;Médicos;227;68;48;20;24089
2020-04-07;León;Todos;Servicios de apoyo no sanitario;7;2;2;0;24089
2020-04-07;Palencia;Todos;Auxiliares sanitarios;26;8;7;1;34120
2020-04-07;Palencia;Todos;Celador;17;10;9;1;34120
2020-04-07;Palencia;Todos;Enfermero/a;71;30;30;0;34120
2020-04-07;Palencia;Todos;Médicos;77;18;11;7;34120
2020-04-07;Palencia;Todos;Personal en formación;17;6;5;1;34120
2020-04-07;Salamanca;Todos;Administrativo;30;14;13;1;37274
2020-04-07;Salamanca;Todos;Auxiliares sanitarios;124;53;51;2;37274
2020-04-07;Salamanca;Todos;Otros sanitarios;5;4;4;0;37274
2020-04-07;Salamanca;Todos;Servicios de apoyo no sanitario;22;11;9;2;37274
2020-04-07;Salamanca;Todos;Técnicos sanitarios;32;14;14;0;37274
2020-04-07;Segovia;Todos;Servicios de apoyo no sanitario;15;9;9;0;40004
2020-04-07;Segovia;Todos;Técnicos sanitarios;22;13;12;1;40004
2020-04-07;Soria;Todos;Administrativo;17;11;11;0;42173
2020-04-07;Soria;Todos;Auxiliares sanitarios;38;21;20;1;42173
2020-04-07;Soria;Todos;Fisioterapeuta;2;1;1;0;42173
2020-04-07;Soria;Todos;Otros sanitarios;2;1;1;0;42173
2020-04-07;Soria;Todos;Técnicos sanitarios;12;9;7;2;42173
2020-04-07;Valladolid;Todos;Fisioterapeuta;8;2;2;0;47186
2020-04-07;Valladolid;Todos;Otros sanitarios;10;4;4;0;47186
2020-04-07;Valladolid;Todos;Personal en formación;70;16;11;5;47186
2020-04-07;Zamora;Todos;Administrativo;4;1;0;1;49275
2020-04-07;Zamora;Todos;Fisioterapeuta;0;0;0;0;49275
2020-04-07;Zamora;Todos;Servicios de apoyo no sanitario;0;0;0;0;49275
2020-04-08;Ávila;Todos;Administrativo;18;14;14;0;5019
2020-04-08;Ávila;Todos;Auxiliares sanitarios;75;33;32;1;5019
2020-04-08;Ávila;Todos;Enfermero/a;172;72;69;3;5019
2020-04-08;Ávila;Todos;Médicos;145;59;49;10;5019
2020-04-08;Ávila;Todos;Otros;1;1;0;1;5019
2020-04-08;Ávila;Todos;Otros sanitarios;7;4;4;0;5019
2020-04-08;Ávila;Todos;Personal en formación;10;4;3;1;5019
2020-04-08;Burgos;Todos;Auxiliares sanitarios;92;31;24;7;9059
2020-04-08;Burgos;Todos;Celador;18;7;5;2;9059
2020-04-08;León;Todos;Fisioterapeuta;4;2;0;2;24089
2020-04-08;León;Todos;Personal en formación;43;15;13;2;24089
2020-04-08;León;Todos;Técnicos sanitarios;16;6;4;2;24089
2020-04-08;Palencia;Todos;Administrativo;8;3;3;0;34120
2020-04-08;Palencia;Todos;Fisioterapeuta;0;0;0;0;34120
2020-04-08;Palencia;Todos;Médicos;80;19;10;9;34120
2020-04-08;Palencia;Todos;Otros sanitarios;4;1;0;1;34120
2020-04-08;Palencia;Todos;Personal en formación;17;6;4;2;34120
2020-04-08;Salamanca;Todos;Celador;43;14;13;1;37274
2020-04-08;Salamanca;Todos;Enfermero/a;254;96;90;6;37274
2020-04-08;Salamanca;Todos;Fisioterapeuta;7;4;4;0;37274
2020-04-08;Salamanca;Todos;Médicos;266;100;74;26;37274
2020-04-08;Salamanca;Todos;Otros sanitarios;5;4;4;0;37274
2020-04-08;Salamanca;Todos;Técnicos sanitarios;32;14;14;0;37274
2020-04-08;Segovia;Todos;Auxiliares sanitarios;76;41;40;1;40004
2020-04-08;Segovia;Todos;Otros;0;0;0;0;40004
2020-04-08;Soria;Todos;Enfermero/a;97;58;40;18;42173
2020-04-08;Soria;Todos;Otros;0;0;0;0;42173
2020-04-08;Valladolid;Todos;Celador;48;18;17;1;47186
2020-04-08;Valladolid;Todos;Servicios de apoyo no sanitario;27;7;7;0;47186
2020-04-08;Valladolid;Todos;Técnicos sanitarios;38;9;6;3;47186
2020-04-08;Zamora;Todos;Médicos;62;19;11;8;49275
2020-04-08;Zamora;Todos;Otros;0;0;0;0;49275
2020-04-08;Zamora;Todos;Servicios de apoyo no sanitario;0;0;0;0;49275
2020-04-09;Ávila;Todos;Auxiliares sanitarios;76;34;31;3;5019
2020-04-09;Ávila;Todos;Fisioterapeuta;5;0;0;0;5019
2020-04-09;Ávila;Todos;Otros;1;1;0;1;5019
2020-04-09;Ávila;Todos;Servicios de apoyo no sanitario;19;8;7;1;5019
2020-04-09;Burgos;Todos;Administrativo;19;7;7;0;9059
2020-04-09;Burgos;Todos;Celador;18;7;5;2;9059
2020-04-09;León;Todos;Celador;51;9;8;1;24089
2020-04-09;León;Todos;Otros;1;0;0;0;24089
2020-04-09;León;Todos;Servicios de apoyo no sanitario;8;2;1;1;24089
2020-04-09;Palencia;Todos;Celador;18;10;9;1;34120
2020-04-09;Palencia;Todos;Enfermero/a;77;34;33;1;34120
2020-04-09;Palencia;Todos;Otros sanitarios;4;1;0;1;34120
2020-04-09;Palencia;Todos;Servicios de apoyo no sanitario;5;2;2;0;34120
2020-04-09;Palencia;Todos;Técnicos sanitarios;3;2;2;0;34120
2020-04-09;Salamanca;Todos;Enfermero/a;260;96;84;12;37274
2020-04-09;Salamanca;Todos;Fisioterapeuta;7;4;4;0;37274
2020-04-09;Salamanca;Todos;Técnicos sanitarios;34;16;14;2;37274
2020-04-09;Segovia;Todos;Administrativo;33;16;13;3;40004
2020-04-09;Segovia;Todos;Auxiliares sanitarios;76;41;39;2;40004
2020-04-09;Segovia;Todos;Médicos;160;70;48;22;40004
2020-04-09;Soria;Todos;Administrativo;22;12;9;3;42173
2020-04-09;Soria;Todos;Enfermero/a;102;61;41;20;42173
2020-04-09;Soria;Todos;Médicos;88;51;36;15;42173
2020-04-09;Soria;Todos;Otros sanitarios;3;2;2;0;42173
2020-04-09;Soria;Todos;Técnicos sanitarios;12;8;5;3;42173
2020-04-09;Valladolid;Todos;Auxiliares sanitarios;131;38;34;4;47186
2020-04-09;Valladolid;Todos;Enfermero/a;402;114;99;15;47186
2020-04-09;Valladolid;Todos;Médicos;381;89;58;31;47186
2020-04-09;Valladolid;Todos;Otros sanitarios;10;4;3;1;47186
2020-04-09;Zamora;Todos;Administrativo;6;3;1;2;49275
2020-04-09;Zamora;Todos;Celador;8;2;2;0;49275
2020-04-09;Zamora;Todos;Otros;0;0;0;0;49275
2020-04-09;Zamora;Todos;Servicios de apoyo no sanitario;0;0;0;0;49275
2020-04-10;Ávila;Todos;Enfermero/a;180;74;66;8;5019
2020-04-10;Ávila;Todos;Personal en formación;10;4;3;1;5019
2020-04-10;Burgos;Todos;Otros;0;0;0;0;9059
2020-04-10;Burgos;Todos;Otros sanitarios;5;0;0;0;9059
2020-04-10;Burgos;Todos;Técnicos sanitarios;16;4;1;3;9059
2020-04-10;Palencia;Todos;Otros sanitarios;4;1;0;1;34120
2020-04-10;Palencia;Todos;Personal en formación;17;6;3;3;34120
2020-04-10;Salamanca;Todos;Auxiliares sanitarios;144;59;51;8;37274
2020-04-10;Salamanca;Todos;Enfermero/a;278;98;84;14;37274
2020-04-10;Salamanca;Todos;Médicos;283;106;64;42;37274
2020-04-10;Segovia;Todos;Administrativo;33;16;12;4;40004
2020-04-10;Segovia;Todos;Auxiliares sanitarios;79;41;38;3;40004
2020-04-10;Segovia;Todos;Celador;30;17;13;4;40004
2020-04-10;Segovia;Todos;Otros;0;0;0;0;40004
2020-04-10;Segovia;Todos;Servicios de apoyo no sanitario;15;9;9;0;40004
2020-04-10;Soria;Todos;Auxiliares sanitarios;48;22;18;4;42173
2020-04-10;Soria;Todos;Celador;16;10;7;3;42173
2020-04-10;Soria;Todos;Otros;0;0;0;0;42173
2020-04-10;Soria;Todos;Personal en formación;10;2;1;1;42173
2020-04-10;Soria;Todos;Servicios de apoyo no sanitario;2;2;2;0;42173
2020-04-10;Soria;Todos;Técnicos sanitarios;12;8;5;3;42173
2020-04-10;Valladolid;Todos;Servicios de apoyo no sanitario;32;8;6;2;47186
2020-04-10;Zamora;Todos;Enfermero/a;60;18;15;3;49275
2020-04-10;Zamora;Todos;Fisioterapeuta;0;0;0;0;49275
2020-04-10;Zamora;Todos;Médicos;67;19;8;11;49275
2020-04-10;Zamora;Todos;Otros sanitarios;2;1;1;0;49275
2020-04-10;Zamora;Todos;Servicios de apoyo no sanitario;0;0;0;0;49275
2020-04-11;Ávila;Todos;Celador;20;5;5;0;5019
2020-04-11;Ávila;Todos;Enfermero/a;184;77;68;9;5019
2020-04-11;Ávila;Todos;Otros;1;1;0;1;5019
2020-04-11;Ávila;Todos;Servicios de apoyo no sanitario;20;9;7;2;5019
2020-04-11;Burgos;Todos;Celador;21;9;6;3;9059
2020-04-11;Burgos;Todos;Médicos;188;49;25;24;9059
2020-04-11;Burgos;Todos;Servicios de apoyo no sanitario;4;1;0;1;9059
2020-04-11;León;Todos;Auxiliares sanitarios;133;42;36;6;24089
2020-04-11;León;Todos;Fisioterapeuta;8;2;0;2;24089
2020-04-11;León;Todos;Otros;2;0;0;0;24089
2020-04-11;León;Todos;Técnicos sanitarios;25;6;4;2;24089
2020-04-11;Palencia;Todos;Enfermero/a;90;37;32;5;34120
2020-04-11;Palencia;Todos;Médicos;92;21;11;10;34120
2020-04-11;Palencia;Todos;Servicios de apoyo no sanitario;7;3;3;0;34120
2020-04-11;Salamanca;Todos;Celador;47;17;14;3;37274
2020-04-11;Salamanca;Todos;Otros;3;1;1;0;37274
2020-04-11;Segovia;Todos;Celador;30;17;13;4;40004
2020-04-11;Segovia;Todos;Enfermero/a;218;115;84;31;40004
2020-04-11;Segovia;Todos;Fisioterapeuta;3;1;0;1;40004
2020-04-11;Segovia;Todos;Otros;0;0;0;0;40004
2020-04-11;Segovia;Todos;Personal en formación;19;9;7;2;40004
2020-04-11;Segovia;Todos;Técnicos sanitarios;22;13;10;3;40004
2020-04-11;Soria;Todos;Celador;16;10;7;3;42173
2020-04-11;Soria;Todos;Otros;0;0;0;0;42173
2020-04-11;Soria;Todos;Otros sanitarios;3;2;2;0;42173
2020-04-11;Soria;Todos;Personal en formación;10;2;1;1;42173
2020-04-11;Soria;Todos;Servicios de apoyo no sanitario;2;2;2;0;42173
2020-04-11;Valladolid;Todos;Auxiliares sanitarios;144;42;36;6;47186
2020-04-11;Valladolid;Todos;Celador;51;17;15;2;47186
2020-04-11;Valladolid;Todos;Fisioterapeuta;12;3;3;0;47186
2020-04-11;Valladolid;Todos;Servicios de apoyo no sanitario;32;8;6;2;47186
2020-04-11;Zamora;Todos;Celador;8;2;2;0;49275
2020-04-11;Zamora;Todos;Enfermero/a;60;18;15;3;49275
2020-04-11;Zamora;Todos;Otros;0;0;0;0;49275
2020-04-12;Ávila;Todos;Enfermero/a;185;77;68;9;5019
2020-04-12;Ávila;Todos;Fisioterapeuta;5;0;0;0;5019
2020-04-12;Ávila;Todos;Técnicos sanitarios;17;7;6;1;5019
2020-04-12;Burgos;Todos;Fisioterapeuta;5;1;0;1;9059
2020-04-12;Burgos;Todos;Técnicos sanitarios;16;4;1;3;9059
2020-04-12;León;Todos;Administrativo;77;12;7;5;24089
2020-04-12;León;Todos;Enfermero/a;438;111;86;25;24089
2020-04-12;León;Todos;Otros;2;0;0;0;24089
2020-04-12;León;Todos;Personal en formación;61;15;12;3;24089
2020-04-12;Palencia;Todos;Administrativo;10;3;3;0;34120
2020-04-12;Palencia;Todos;Enfermero/a;93;37;32;5;34120
2020-04-12;Palencia;Todos;Fisioterapeuta;0;0;0;0;34120
2020-04-12;Palencia;Todos;Médicos;94;21;11;10;34120
2020-04-12;Palencia;Todos;Técnicos sanitarios;4;2;2;0;34120
2020-04-12;Salamanca;Todos;Administrativo;35;17;14;3;37274
2020-04-12;Salamanca;Todos;Otros;3;1;1;0;37274
2020-04-12;Segovia;Todos;Auxiliares sanitarios;87;43;39;4;40004
2020-04-12;Segovia;Todos;Celador;30;17;13;4;40004
2020-04-12;Segovia;Todos;Médicos;167;72;44;28;40004
2020-04-12;Segovia;Todos;Otros;0;0;0;0;40004
2020-04-12;Soria;Todos;Enfermero/a;105;62;36;26;42173
2020-04-12;Soria;Todos;Personal en formación;10;2;1;1;42173
2020-04-12;Soria;Todos;Servicios de apoyo no sanitario;2;2;2;0;42173
2020-04-12;Soria;Todos;Técnicos sanitarios;12;8;5;3;42173
2020-04-12;Valladolid;Todos;Administrativo;71;21;18;3;47186
2020-04-12;Valladolid;Todos;Enfermero/a;440;123;105;18;47186
2020-04-12;Valladolid;Todos;Fisioterapeuta;13;3;3;0;47186
2020-04-12;Valladolid;Todos;Otros;0;0;0;0;47186
2020-04-12;Valladolid;Todos;Otros sanitarios;11;4;3;1;47186
2020-04-12;Valladolid;Todos;Servicios de apoyo no sanitario;34;8;6;2;47186
2020-04-12;Zamora;Todos;Administrativo;6;3;1;2;49275
2020-04-12;Zamora;Todos;Celador;10;2;2;0;49275
2020-04-12;Zamora;Todos;Servicios de apoyo no sanitario;0;0;0;0;49275
2020-04-13;Ávila;Todos;Auxiliares sanitarios;83;36;34;2;5019
2020-04-13;Ávila;Todos;Celador;20;5;5;0;5019
2020-04-13;Ávila;Todos;Enfermero/a;187;77;68;9;5019
2020-04-13;Ávila;Todos;Fisioterapeuta;5;0;0;0;5019
2020-04-13;Ávila;Todos;Otros sanitarios;9;5;5;0;5019
2020-04-13;Ávila;Todos;Personal en formación;10;4;3;1;5019
2020-04-13;Burgos;Todos;Otros sanitarios;7;0;0;0;9059
2020-04-13;León;Todos;Celador;73;9;7;2;24089
2020-04-13;León;Todos;Servicios de apoyo no sanitario;9;2;1;1;24089
2020-04-13;Palencia;Todos;Enfermero/a;109;38;32;6;34120
2020-04-13;Palencia;Todos;Fisioterapeuta;1;0;0;0;34120
2020-04-13;Palencia;Todos;Servicios de apoyo no sanitario;12;3;3;0;34120
2020-04-13;Salamanca;Todos;Administrativo;38;18;15;3;37274
2020-04-13;Salamanca;Todos;Auxiliares sanitarios;155;65;56;9;37274
2020-04-13;Salamanca;Todos;Médicos;292;109;59;50;37274
2020-04-13;Salamanca;Todos;Personal en formación;51;20;9;11;37274
2020-04-13;Segovia;Todos;Auxiliares sanitarios;90;44;39;5;40004
2020-04-13;Segovia;Todos;Personal en formación;19;9;5;4;40004
2020-04-13;Segovia;Todos;Técnicos sanitarios;23;13;11;2;40004
2020-04-13;Soria;Todos;Administrativo;23;12;7;5;42173
2020-04-13;Soria;Todos;Fisioterapeuta;2;1;1;0;42173
2020-04-13;Soria;Todos;Médicos;91;51;26;25;42173
2020-04-13;Soria;Todos;Servicios de apoyo no sanitario;2;2;2;0;42173
2020-04-13;Soria;Todos;Técnicos sanitarios;12;8;5;3;42173
2020-04-13;Valladolid;Todos;Auxiliares sanitarios;160;44;37;7;47186
2020-04-13;Valladolid;Todos;Fisioterapeuta;17;3;3;0;47186
2020-04-13;Valladolid;Todos;Médicos;451;97;54;43;47186
2020-04-13;Valladolid;Todos;Otros;0;0;0;0;47186
2020-04-13;Zamora;Todos;Auxiliares sanitarios;12;2;2;0;49275
2020-04-13;Zamora;Todos;Celador;10;2;2;0;49275
2020-04-13;Zamora;Todos;Personal en formación;2;0;0;0;49275
2020-04-14;Ávila;Todos;Administrativo;20;15;12;3;5019
2020-04-14;Ávila;Todos;Otros sanitarios;9;5;5;0;5019
2020-04-14;Ávila;Todos;Servicios de apoyo no sanitario;21;9;7;2;5019
2020-04-14;Ávila;Todos;Técnicos sanitarios;19;7;6;1;5019
2020-04-14;Burgos;Todos;Administrativo;69;8;5;3;9059
2020-04-14;Burgos;Todos;Enfermero/a;350;67;39;28;9059
2020-04-14;Burgos;Todos;Otros;2;1;0;1;9059
2020-04-14;León;Todos;Otros;3;0;0;0;24089
2020-04-14;León;Todos;Personal en formación;75;15;11;4;24089
2020-04-14;Palencia;Todos;Auxiliares sanitarios;50;14;13;1;34120
2020-04-14;Palencia;Todos;Enfermero/a;119;39;32;7;34120
2020-04-14;Palencia;Todos;Servicios de apoyo no sanitario;13;3;3;0;34120
2020-04-14;Salamanca;Todos;Administrativo;41;19;15;4;37274
2020-04-14;Salamanca;Todos;Fisioterapeuta;7;4;4;0;37274
2020-04-14;Salamanca;Todos;Servicios de apoyo no sanitario;27;13;8;5;37274
2020-04-14;Salamanca;Todos;Técnicos sanitarios;36;17;14;3;37274
2020-04-14;Segovia;Todos;Administrativo;33;16;9;7;40004
2020-04-14;Segovia;Todos;Auxiliares sanitarios;92;44;37;7;40004
2020-04-14;Segovia;Todos;Celador;32;18;10;8;40004
2020-04-14;Segovia;Todos;Enfermero/a;235;119;69;50;40004
2020-04-14;Segovia;Todos;Personal en formación;21;10;6;4;40004
2020-04-14;Segovia;Todos;Servicios de apoyo no sanitario;16;9;5;4;40004
2020-04-14;Soria;Todos;Auxiliares sanitarios;49;22;10;12;42173
2020-04-14;Soria;Todos;Enfermero/a;106;63;36;27;42173
2020-04-14;Soria;Todos;Médicos;91;51;26;25;42173
2020-04-14;Soria;Todos;Otros;0;0;0;0;42173
2020-04-14;Valladolid;Todos;Otros;0;0;0;0;47186
2020-04-14;Valladolid;Todos;Otros sanitarios;15;4;3;1;47186
2020-04-14;Zamora;Todos;Fisioterapeuta;0;0;0;0;49275
2020-04-14;Zamora;Todos;Otros sanitarios;2;1;1;0;49275
2020-04-14;Zamora;Todos;Servicios de apoyo no sanitario;0;0;0;0;49275
2020-04-15;Ávila;Todos;Celador;23;5;5;0;5019
2020-04-15;Ávila;Todos;Enfermero/a;196;78;66;12;5019
2020-04-15;Ávila;Todos;Médicos;169;66;45;21;5019
2020-04-15;Ávila;Todos;Otros;1;1;0;1;5019
2020-04-15;Ávila;Todos;Otros sanitarios;9;5;5;0;5019
2020-04-15;Burgos;Todos;Administrativo;85;8;5;3;9059
2020-04-15;Burgos;Todos;Otros;2;1;0;1;9059
2020-04-15;León;Todos;Celador;80;13;9;4;24089
2020-04-15;León;Todos;Otros sanitarios;22;3;3;0;24089
2020-04-15;León;Todos;Servicios de apoyo no sanitario;9;2;0;2;24089
2020-04-15;Palencia;Todos;Auxiliares sanitarios;52;14;13;1;34120
2020-04-15;Palencia;Todos;Enfermero/a;133;39;31;8;34120
2020-04-15;Palencia;Todos;Fisioterapeuta;2;0;0;0;34120
2020-04-15;Palencia;Todos;Médicos;118;21;11;10;34120
2020-04-15;Palencia;Todos;Otros sanitarios;7;1;0;1;34120
2020-04-15;Palencia;Todos;Técnicos sanitarios;5;3;3;0;34120
2020-04-15;Salamanca;Todos;Otros sanitarios;6;4;4;0;37274
2020-04-15;Salamanca;Todos;Personal en formación;58;22;11;11;37274
2020-04-15;Segovia;Todos;Celador;34;18;11;7;40004
2020-04-15;Segovia;Todos;Enfermero/a;239;119;62;57;40004
2020-04-15;Segovia;Todos;Fisioterapeuta;4;1;0;1;40004
2020-04-15;Segovia;Todos;Médicos;176;75;35;40;40004
2020-04-15;Segovia;Todos;Técnicos sanitarios;28;13;7;6;40004
2020-04-15;Soria;Todos;Auxiliares sanitarios;52;22;9;13;42173
2020-04-15;Soria;Todos;Celador;17;10;6;4;42173
2020-04-15;Soria;Todos;Fisioterapeuta;2;1;1;0;42173
2020-04-15;Soria;Todos;Médicos;95;53;25;28;42173
2020-04-15;Soria;Todos;Otros;0;0;0;0;42173
2020-04-15;Soria;Todos;Técnicos sanitarios;12;8;5;3;42173
2020-04-15;Valladolid;Todos;Auxiliares sanitarios;186;45;36;9;47186
2020-04-15;Valladolid;Todos;Fisioterapeuta;29;3;3;0;47186
2020-04-15;Valladolid;Todos;Médicos;588;100;52;48;47186
2020-04-15;Valladolid;Todos;Otros;1;0;0;0;47186
2020-04-15;Valladolid;Todos;Otros sanitarios;16;4;3;1;47186
2020-04-15;Valladolid;Todos;Personal en formación;129;22;12;10;47186
2020-04-15;Valladolid;Todos;Técnicos sanitarios;55;9;5;4;47186
2020-04-15;Zamora;Todos;Celador;11;2;2;0;49275
2020-04-15;Zamora;Todos;Enfermero/a;69;20;16;4;49275
2020-04-15;Zamora;Todos;Fisioterapeuta;0;0;0;0;49275
2020-04-15;Zamora;Todos;Otros;0;0;0;0;49275
2020-04-16;Ávila;Todos;Auxiliares sanitarios;91;37;34;3;5019
2020-04-16;Ávila;Todos;Celador;23;5;5;0;5019
2020-04-16;Ávila;Todos;Enfermero/a;201;79;66;13;5019
2020-04-16;Ávila;Todos;Otros;1;1;0;1;5019
2020-04-16;Ávila;Todos;Personal en formación;10;4;2;2;5019
2020-04-16;Ávila;Todos;Servicios de apoyo no sanitario;21;9;7;2;5019
2020-04-16;Burgos;Todos;Administrativo;91;8;5;3;9059
2020-04-16;Burgos;Todos;Otros;7;1;0;1;9059
2020-04-16;Burgos;Todos;Otros sanitarios;12;0;0;0;9059
2020-04-16;Burgos;Todos;Personal en formación;26;4;0;4;9059
2020-04-16;León;Todos;Servicios de apoyo no sanitario;10;3;1;2;24089
2020-04-16;León;Todos;Técnicos sanitarios;35;6;4;2;24089
2020-04-16;Palencia;Todos;Otros;2;0;0;0;34120
2020-04-16;Salamanca;Todos;Administrativo;46;19;10;9;37274
2020-04-16;Salamanca;Todos;Celador;56;21;18;3;37274
2020-04-16;Salamanca;Todos;Enfermero/a;362;110;70;40;37274
2020-04-16;Salamanca;Todos;Fisioterapeuta;7;4;4;0;37274
2020-04-16;Segovia;Todos;Celador;35;18;11;7;40004
2020-04-16;Segovia;Todos;Personal en formación;23;10;6;4;40004
2020-04-16;Soria;Todos;Fisioterapeuta;3;1;1;0;42173
2020-04-16;Soria;Todos;Médicos;96;53;24;29;42173
2020-04-16;Valladolid;Todos;Otros sanitarios;18;4;3;1;47186
2020-04-16;Valladolid;Todos;Servicios de apoyo no sanitario;37;8;5;3;47186
2020-04-16;Zamora;Todos;Administrativo;7;4;2;2;49275
2020-04-16;Zamora;Todos;Celador;11;2;2;0;49275
2020-04-16;Zamora;Todos;Otros sanitarios;2;1;1;0;49275
2020-04-16;Zamora;Todos;Servicios de apoyo no sanitario;0;0;0;0;49275
2020-04-17;Ávila;Todos;Auxiliares sanitarios;92;37;34;3;5019
2020-04-17;Ávila;Todos;Celador;23;5;5;0;5019
2020-04-17;Ávila;Todos;Fisioterapeuta;5;0;0;0;5019
2020-04-17;Ávila;Todos;Técnicos sanitarios;19;7;6;1;5019
2020-04-17;Burgos;Todos;Fisioterapeuta;17;1;0;1;9059
2020-04-17;Burgos;Todos;Otros sanitarios;14;0;0;0;9059
2020-04-17;Burgos;Todos;Técnicos sanitarios;23;4;1;3;9059
2020-04-17;León;Todos;Auxiliares sanitarios;240;49;36;13;24089
2020-04-17;León;Todos;Enfermero/a;690;132;80;52;24089
2020-04-17;León;Todos;Médicos;522;88;43;45;24089
2020-04-17;León;Todos;Otros;3;0;0;0;24089
2020-04-17;León;Todos;Personal en formación;79;15;10;5;24089
2020-04-17;León;Todos;Servicios de apoyo no sanitario;11;3;1;2;24089
2020-04-17;Palencia;Todos;Celador;31;11;9;2;34120
2020-04-17;Palencia;Todos;Otros;2;0;0;0;34120
2020-04-17;Palencia;Todos;Servicios de apoyo no sanitario;14;3;3;0;34120
2020-04-17;Salamanca;Todos;Administrativo;50;19;9;10;37274
2020-04-17;Salamanca;Todos;Otros;3;1;1;0;37274
2020-04-17;Salamanca;Todos;Personal en formación;63;22;10;12;37274
2020-04-17;Segovia;Todos;Enfermero/a;256;121;49;72;40004
2020-04-17;Segovia;Todos;Técnicos sanitarios;28;13;6;7;40004
2020-04-17;Soria;Todos;Administrativo;23;12;6;6;42173
2020-04-17;Valladolid;Todos;Administrativo;183;24;14;10;47186
2020-04-17;Valladolid;Todos;Auxiliares sanitarios;212;48;37;11;47186
2020-04-17;Valladolid;Todos;Enfermero/a;707;134;88;46;47186
2020-04-17;Valladolid;Todos;Fisioterapeuta;32;3;2;1;47186
2020-04-17;Valladolid;Todos;Personal en formación;153;23;9;14;47186
2020-04-17;Valladolid;Todos;Servicios de apoyo no sanitario;37;8;4;4;47186
2020-04-17;Zamora;Todos;Auxiliares sanitarios;15;4;4;0;49275
2020-04-17;Zamora;Todos;Celador;11;2;2;0;49275
2020-04-17;Zamora;Todos;Enfermero/a;71;20;16;4;49275
2020-04-17;Zamora;Todos;Otros sanitarios;2;1;1;0;49275
2020-04-17;Zamora;Todos;Personal en formación;2;0;0;0;49275
2020-04-18;Ávila;Todos;Administrativo;24;16;11;5;5019
2020-04-18;Ávila;Todos;Fisioterapeuta;5;0;0;0;5019
2020-04-18;Ávila;Todos;Otros;1;1;0;1;5019
2020-04-18;Ávila;Todos;Personal en formación;10;4;2;2;5019
2020-04-18;Burgos;Todos;Administrativo;98;8;5;3;9059
2020-04-18;Burgos;Todos;Otros sanitarios;14;0;0;0;9059
2020-04-18;Burgos;Todos;Servicios de apoyo no sanitario;11;2;1;1;9059
2020-04-18;León;Todos;Administrativo;100;14;6;8;24089
2020-04-18;León;Todos;Celador;90;14;10;4;24089
2020-04-18;León;Todos;Otros;4;0;0;0;24089
2020-04-18;Palencia;Todos;Auxiliares sanitarios;54;14;13;1;34120
2020-04-18;Palencia;Todos;Enfermero/a;152;40;32;8;34120
2020-04-18;Palencia;Todos;Fisioterapeuta;5;0;0;0;34120
2020-04-18;Palencia;Todos;Servicios de apoyo no sanitario;14;3;3;0;34120
2020-04-18;Salamanca;Todos;Administrativo;50;19;9;10;37274
2020-04-18;Salamanca;Todos;Auxiliares sanitarios;190;71;43;28;37274
2020-04-18;Salamanca;Todos;Fisioterapeuta;7;4;2;2;37274
2020-04-18;Salamanca;Todos;Otros sanitarios;8;4;4;0;37274
2020-04-18;Salamanca;Todos;Servicios de apoyo no sanitario;30;13;6;7;37274
2020-04-18;Salamanca;Todos;Técnicos sanitarios;39;17;11;6;37274
2020-04-18;Segovia;Todos;Fisioterapeuta;4;1;0;1;40004
2020-04-18;Segovia;Todos;Médicos;187;77;27;50;40004
2020-04-18;Segovia;Todos;Otros sanitarios;2;1;1;0;40004
2020-04-18;Soria;Todos;Auxiliares sanitarios;57;22;8;14;42173
2020-04-18;Soria;Todos;Otros sanitarios;3;2;1;1;42173
2020-04-18;Soria;Todos;Técnicos sanitarios;13;8;4;4;42173
2020-04-18;Valladolid;Todos;Otros sanitarios;18;4;1;3;47186
2020-04-18;Valladolid;Todos;Personal en formación;153;23;9;14;47186
2020-04-18;Valladolid;Todos;Técnicos sanitarios;58;9;5;4;47186
2020-04-18;Zamora;Todos;Auxiliares sanitarios;15;4;4;0;49275
2020-04-18;Zamora;Todos;Celador;11;2;2;0;49275
2020-04-18;Zamora;Todos;Fisioterapeuta;0;0;0;0;49275
2020-04-18;Zamora;Todos;Médicos;73;20;5;15;49275
2020-04-18;Zamora;Todos;Personal en formación;2;0;0;0;49275
2020-04-19;Ávila;Todos;Técnicos sanitarios;19;7;6;1;5019
2020-04-19;Burgos;Todos;Enfermero/a;449;72;36;36;9059
2020-04-19;Burgos;Todos;Médicos;383;55;23;32;9059
2020-04-19;León;Todos;Fisioterapeuta;16;2;0;2;24089
2020-04-19;Palencia;Todos;Fisioterapeuta;5;0;0;0;34120
2020-04-19;Palencia;Todos;Otros sanitarios;7;1;0;1;34120
2020-04-19;Palencia;Todos;Personal en formación;18;6;3;3;34120
2020-04-19;Palencia;Todos;Servicios de apoyo no sanitario;14;3;3;0;34120
2020-04-19;Salamanca;Todos;Auxiliares sanitarios;193;72;44;28;37274
2020-04-19;Salamanca;Todos;Médicos;336;118;49;69;37274
2020-04-19;Salamanca;Todos;Otros;3;1;1;0;37274
2020-04-19;Salamanca;Todos;Servicios de apoyo no sanitario;30;13;6;7;37274
2020-04-19;Salamanca;Todos;Técnicos sanitarios;39;17;11;6;37274
2020-04-19;Segovia;Todos;Administrativo;38;16;5;11;40004
2020-04-19;Segovia;Todos;Auxiliares sanitarios;99;46;32;14;40004
2020-04-19;Segovia;Todos;Fisioterapeuta;4;1;0;1;40004
2020-04-19;Segovia;Todos;Médicos;187;79;25;54;40004
2020-04-19;Segovia;Todos;Otros sanitarios;2;1;1;0;40004
2020-04-19;Soria;Todos;Auxiliares sanitarios;59;23;9;14;42173
2020-04-19;Soria;Todos;Otros;0;0;0;0;42173
2020-04-19;Soria;Todos;Personal en formación;10;2;1;1;42173
2020-04-19;Valladolid;Todos;Celador;88;18;14;4;47186
2020-04-19;Valladolid;Todos;Enfermero/a;716;137;89;48;47186
2020-04-19;Valladolid;Todos;Personal en formación;153;23;9;14;47186
2020-04-19;Zamora;Todos;Administrativo;7;4;2;2;49275
2020-04-19;Zamora;Todos;Auxiliares sanitarios;15;4;4;0;49275
2020-04-19;Zamora;Todos;Médicos;75;20;5;15;49275
2020-04-19;Zamora;Todos;Personal en formación;2;0;0;0;49275
2020-04-19;Zamora;Todos;Técnicos sanitarios;4;0;0;0;49275
2020-04-20;Ávila;Todos;Médicos;181;70;45;25;5019
2020-04-20;Ávila;Todos;Otros sanitarios;10;5;5;0;5019
2020-04-20;Ávila;Todos;Servicios de apoyo no sanitario;22;9;7;2;5019
2020-04-20;Burgos;Todos;Auxiliares sanitarios;153;38;21;17;9059
2020-04-20;Burgos;Todos;Médicos;392;56;21;35;9059
2020-04-20;Burgos;Todos;Otros sanitarios;14;0;0;0;9059
2020-04-20;León;Todos;Celador;91;14;7;7;24089
2020-04-20;León;Todos;Fisioterapeuta;16;2;0;2;24089
2020-04-20;León;Todos;Servicios de apoyo no sanitario;14;3;1;2;24089
2020-04-20;Palencia;Todos;Auxiliares sanitarios;56;14;13;1;34120
2020-04-20;Palencia;Todos;Celador;32;12;10;2;34120
2020-04-20;Palencia;Todos;Personal en formación;18;6;3;3;34120
2020-04-20;Palencia;Todos;Servicios de apoyo no sanitario;14;3;3;0;34120
2020-04-20;Palencia;Todos;Técnicos sanitarios;6;3;3;0;34120
2020-04-20;Salamanca;Todos;Enfermero/a;408;119;58;61;37274
2020-04-20;Salamanca;Todos;Personal en formación;69;24;11;13;37274
2020-04-20;Segovia;Todos;Fisioterapeuta;4;1;0;1;40004
2020-04-20;Segovia;Todos;Servicios de apoyo no sanitario;18;9;4;5;40004
2020-04-20;Segovia;Todos;Técnicos sanitarios;29;13;6;7;40004
2020-04-20;Soria;Todos;Otros sanitarios;3;2;1;1;42173
2020-04-20;Soria;Todos;Servicios de apoyo no sanitario;3;2;1;1;42173
2020-04-20;Valladolid;Todos;Administrativo;207;25;13;12;47186
2020-04-20;Valladolid;Todos;Celador;93;18;14;4;47186
2020-04-20;Valladolid;Todos;Enfermero/a;772;138;88;50;47186
2020-04-20;Valladolid;Todos;Fisioterapeuta;37;3;2;1;47186
2020-04-20;Valladolid;Todos;Otros;3;0;0;0;47186
2020-04-20;Valladolid;Todos;Servicios de apoyo no sanitario;38;8;4;4;47186
2020-04-20;Zamora;Todos;Administrativo;13;6;4;2;49275
2020-04-20;Zamora;Todos;Auxiliares sanitarios;30;5;5;0;49275
2020-04-20;Zamora;Todos;Fisioterapeuta;1;1;1;0;49275
2020-04-20;Zamora;Todos;Otros;0;0;0;0;49275
2020-04-21;Ávila;Todos;Auxiliares sanitarios;102;38;33;5;5019
2020-04-21;Ávila;Todos;Fisioterapeuta;6;0;0;0;5019
2020-04-21;Ávila;Todos;Médicos;180;69;44;25;5019
2020-04-21;Ávila;Todos;Otros sanitarios;10;5;5;0;5019
2020-04-21;Burgos;Todos;Administrativo;106;9;4;5;9059
2020-04-21;Burgos;Todos;Otros sanitarios;14;0;0;0;9059
2020-04-21;Burgos;Todos;Personal en formación;34;4;0;4;9059
2020-04-21;Burgos;Todos;Servicios de apoyo no sanitario;11;2;1;1;9059
2020-04-21;León;Todos;Fisioterapeuta;16;2;0;2;24089
2020-04-21;León;Todos;Otros sanitarios;23;3;1;2;24089
2020-04-21;León;Todos;Servicios de apoyo no sanitario;17;3;1;2;24089
2020-04-21;León;Todos;Técnicos sanitarios;42;6;2;4;24089
2020-04-21;Palencia;Todos;Administrativo;59;5;5;0;34120
2020-04-21;Palencia;Todos;Fisioterapeuta;6;1;1;0;34120
2020-04-21;Palencia;Todos;Otros sanitarios;7;1;0;1;34120
2020-04-21;Palencia;Todos;Personal en formación;18;6;3;3;34120
2020-04-21;Palencia;Todos;Servicios de apoyo no sanitario;14;3;3;0;34120
2020-04-21;Palencia;Todos;Técnicos sanitarios;7;3;3;0;34120
2020-04-21;Salamanca;Todos;Celador;63;24;16;8;37274
2020-04-21;Salamanca;Todos;Enfermero/a;416;120;57;63;37274
2020-04-21;Salamanca;Todos;Otros sanitarios;8;4;4;0;37274
2020-04-21;Salamanca;Todos;Personal en formación;77;25;13;12;37274
2020-04-21;Salamanca;Todos;Servicios de apoyo no sanitario;33;14;6;8;37274
2020-04-21;Segovia;Todos;Enfermero/a;275;125;37;88;40004
2020-04-21;Segovia;Todos;Médicos;193;79;18;61;40004
2020-04-21;Segovia;Todos;Otros;0;0;0;0;40004
2020-04-21;Soria;Todos;Médicos;122;56;25;31;42173
2020-04-21;Soria;Todos;Personal en formación;11;2;1;1;42173
2020-04-21;Valladolid;Todos;Enfermero/a;816;141;84;57;47186
2020-04-21;Valladolid;Todos;Fisioterapeuta;38;3;2;1;47186
2020-04-21;Valladolid;Todos;Personal en formación;173;24;7;17;47186
2020-04-21;Zamora;Todos;Celador;17;2;1;1;49275
2020-04-21;Zamora;Todos;Enfermero/a;106;22;14;8;49275
2020-04-21;Zamora;Todos;Médicos;111;19;6;13;49275
2020-04-21;Zamora;Todos;Personal en formación;3;0;0;0;49275
2020-04-21;Zamora;Todos;Servicios de apoyo no sanitario;1;0;0;0;49275
2020-04-22;Ávila;Todos;Médicos;184;69;44;25;5019
2020-04-22;Ávila;Todos;Personal en formación;10;4;2;2;5019
2020-04-22;Burgos;Todos;Enfermero/a;516;75;32;43;9059
2020-04-22;Burgos;Todos;Otros sanitarios;15;0;0;0;9059
2020-04-22;Burgos;Todos;Servicios de apoyo no sanitario;12;3;2;1;9059
2020-04-22;Burgos;Todos;Técnicos sanitarios;30;4;0;4;9059
2020-04-22;León;Todos;Enfermero/a;831;143;83;60;24089
2020-04-22;León;Todos;Fisioterapeuta;17;2;0;2;24089
2020-04-22;Palencia;Todos;Servicios de apoyo no sanitario;14;3;3;0;34120
2020-04-22;Palencia;Todos;Técnicos sanitarios;8;3;3;0;34120
2020-04-22;Salamanca;Todos;Administrativo;55;20;9;11;37274
2020-04-22;Salamanca;Todos;Fisioterapeuta;7;4;1;3;37274
2020-04-22;Salamanca;Todos;Otros;4;2;2;0;37274
2020-04-22;Salamanca;Todos;Servicios de apoyo no sanitario;33;14;7;7;37274
2020-04-22;Segovia;Todos;Celador;50;21;11;10;40004
2020-04-22;Segovia;Todos;Fisioterapeuta;4;1;0;1;40004
2020-04-22;Segovia;Todos;Médicos;198;79;16;63;40004
2020-04-22;Segovia;Todos;Personal en formación;26;11;4;7;40004
2020-04-22;Soria;Todos;Celador;28;10;3;7;42173
2020-04-22;Soria;Todos;Fisioterapeuta;5;1;0;1;42173
2020-04-22;Soria;Todos;Médicos;138;58;22;36;42173
2020-04-22;Soria;Todos;Otros sanitarios;4;2;1;1;42173
2020-04-22;Soria;Todos;Personal en formación;17;2;1;1;42173
2020-04-22;Valladolid;Todos;Fisioterapeuta;39;4;3;1;47186
2020-04-22;Valladolid;Todos;Servicios de apoyo no sanitario;42;8;4;4;47186
2020-04-22;Valladolid;Todos;Técnicos sanitarios;68;10;5;5;47186
2020-04-22;Zamora;Todos;Personal en formación;6;0;0;0;49275
2020-04-22;Zamora;Todos;Técnicos sanitarios;4;0;0;0;49275
2020-04-23;Ávila;Todos;Administrativo;25;16;12;4;5019
2020-04-23;Ávila;Todos;Celador;38;8;6;2;5019
2020-04-23;Ávila;Todos;Enfermero/a;235;81;63;18;5019
2020-04-23;Ávila;Todos;Fisioterapeuta;6;0;0;0;5019
2020-04-23;Ávila;Todos;Médicos;192;70;44;26;5019
2020-04-23;Burgos;Todos;Médicos;412;59;23;36;9059
2020-04-23;Burgos;Todos;Otros;7;1;0;1;9059
2020-04-23;Burgos;Todos;Otros sanitarios;15;0;0;0;9059
2020-04-23;Burgos;Todos;Técnicos sanitarios;30;4;0;4;9059
2020-04-23;León;Todos;Administrativo;127;14;5;9;24089
2020-04-23;León;Todos;Auxiliares sanitarios;318;55;28;27;24089
2020-04-23;León;Todos;Fisioterapeuta;17;2;0;2;24089
2020-04-23;León;Todos;Médicos;617;93;32;61;24089
2020-04-23;Palencia;Todos;Administrativo;59;5;5;0;34120
2020-04-23;Palencia;Todos;Auxiliares sanitarios;61;15;10;5;34120
2020-04-23;Palencia;Todos;Fisioterapeuta;6;1;1;0;34120
2020-04-23;Palencia;Todos;Médicos;155;23;9;14;34120
2020-04-23;Palencia;Todos;Otros;3;0;0;0;34120
2020-04-23;Palencia;Todos;Personal en formación;18;6;2;4;34120
2020-04-23;Salamanca;Todos;Celador;66;25;14;11;37274
2020-04-23;Salamanca;Todos;Fisioterapeuta;7;4;1;3;37274
2020-04-23;Salamanca;Todos;Otros;4;2;2;0;37274
2020-04-23;Segovia;Todos;Enfermero/a;281;125;30;95;40004
2020-04-23;Segovia;Todos;Médicos;198;79;15;64;40004
2020-04-23;Segovia;Todos;Otros sanitarios;2;1;1;0;40004
2020-04-23;Soria;Todos;Administrativo;32;15;8;7;42173
2020-04-23;Soria;Todos;Fisioterapeuta;5;1;0;1;42173
2020-04-23;Soria;Todos;Médicos;138;58;22;36;42173
2020-04-23;Soria;Todos;Otros sanitarios;4;2;1;1;42173
2020-04-23;Soria;Todos;Personal en formación;17;2;1;1;42173
2020-04-23;Valladolid;Todos;Administrativo;229;27;12;15;47186
2020-04-23;Valladolid;Todos;Personal en formación;192;26;9;17;47186
2020-04-23;Zamora;Todos;Médicos;140;19;5;14;49275
2020-04-23;Zamora;Todos;Otros sanitarios;3;1;0;1;49275
2020-04-24;Ávila;Todos;Administrativo;27;16;12;4;5019
2020-04-24;Ávila;Todos;Auxiliares sanitarios;148;40;32;8;5019
2020-04-24;Ávila;Todos;Celador;53;9;8;1;5019
2020-04-24;Ávila;Todos;Fisioterapeuta;7;0;0;0;5019
2020-04-24;Burgos;Todos;Fisioterapeuta;19;2;1;1;9059
2020-04-24;Burgos;Todos;Personal en formación;42;4;0;4;9059
2020-04-24;Burgos;Todos;Técnicos sanitarios;37;4;0;4;9059
2020-04-24;León;Todos;Celador;173;19;11;8;24089
2020-04-24;León;Todos;Enfermero/a;843;142;73;69;24089
2020-04-24;León;Todos;Médicos;626;90;29;61;24089
2020-04-24;León;Todos;Otros;6;0;0;0;24089
2020-04-24;León;Todos;Otros sanitarios;24;3;1;2;24089
2020-04-24;León;Todos;Servicios de apoyo no sanitario;17;3;1;2;24089
2020-04-24;Palencia;Todos;Enfermero/a;181;42;32;10;34120
2020-04-24;Palencia;Todos;Otros;3;0;0;0;34120
2020-04-24;Palencia;Todos;Personal en formación;18;6;2;4;34120
2020-04-24;Palencia;Todos;Servicios de apoyo no sanitario;14;3;2;1;34120
2020-04-24;Salamanca;Todos;Médicos;366;126;43;83;37274
2020-04-24;Segovia;Todos;Administrativo;56;18;7;11;40004
2020-04-24;Segovia;Todos;Otros;0;0;0;0;40004
2020-04-24;Soria;Todos;Administrativo;46;17;9;8;42173
2020-04-24;Soria;Todos;Celador;49;10;2;8;42173
2020-04-24;Soria;Todos;Médicos;167;61;21;40;42173
2020-04-24;Soria;Todos;Personal en formación;25;2;1;1;42173
2020-04-24;Soria;Todos;Técnicos sanitarios;20;8;3;5;42173
2020-04-24;Valladolid;Todos;Otros;4;0;0;0;47186
2020-04-24;Valladolid;Todos;Otros sanitarios;21;4;1;3;47186
2020-04-24;Valladolid;Todos;Personal en formación;194;26;8;18;47186
2020-04-24;Valladolid;Todos;Servicios de apoyo no sanitario;43;8;4;4;47186
2020-04-24;Zamora;Todos;Auxiliares sanitarios;69;6;5;1;49275
2020-04-24;Zamora;Todos;Enfermero/a;144;21;14;7;49275
2020-04-24;Zamora;Todos;Servicios de apoyo no sanitario;1;0;0;0;49275
2020-04-24;Zamora;Todos;Técnicos sanitarios;6;0;0;0;49275
2020-04-25;Ávila;Todos;Enfermero/a;290;83;66;17;5019
2020-04-25;Ávila;Todos;Fisioterapeuta;7;0;0;0;5019
2020-04-25;Ávila;Todos;Otros sanitarios;10;5;5;0;5019
2020-04-25;Ávila;Todos;Personal en formación;17;4;2;2;5019
2020-04-25;Ávila;Todos;Servicios de apoyo no sanitario;22;9;8;1;5019
2020-04-25;Ávila;Todos;Técnicos sanitarios;19;7;6;1;5019
2020-04-25;Burgos;Todos;Administrativo;109;9;4;5;9059
2020-04-25;Burgos;Todos;Auxiliares sanitarios;236;44;22;22;9059
2020-04-25;Burgos;Todos;Enfermero/a;567;75;27;48;9059
2020-04-25;Burgos;Todos;Médicos;438;59;22;37;9059
2020-04-25;León;Todos;Enfermero/a;848;142;71;71;24089
2020-04-25;León;Todos;Otros;6;0;0;0;24089
2020-04-25;Palencia;Todos;Administrativo;59;5;4;1;34120
2020-04-25;Palencia;Todos;Enfermero/a;183;42;32;10;34120
2020-04-25;Palencia;Todos;Médicos;159;27;11;16;34120
2020-04-25;Palencia;Todos;Otros sanitarios;7;1;0;1;34120
2020-04-25;Palencia;Todos;Servicios de apoyo no sanitario;14;3;1;2;34120
2020-04-25;Salamanca;Todos;Enfermero/a;434;121;48;73;37274
2020-04-25;Salamanca;Todos;Otros;4;3;3;0;37274
2020-04-25;Salamanca;Todos;Otros sanitarios;8;4;3;1;37274
2020-04-25;Segovia;Todos;Administrativo;56;18;7;11;40004
2020-04-25;Segovia;Todos;Enfermero/a;295;124;22;102;40004
2020-04-25;Segovia;Todos;Fisioterapeuta;4;1;0;1;40004
2020-04-25;Segovia;Todos;Técnicos sanitarios;32;13;6;7;40004
2020-04-25;Soria;Todos;Auxiliares sanitarios;85;24;11;13;42173
2020-04-25;Soria;Todos;Celador;50;10;2;8;42173
2020-04-25;Soria;Todos;Enfermero/a;197;71;29;42;42173
2020-04-25;Soria;Todos;Médicos;167;61;21;40;42173
2020-04-25;Soria;Todos;Otros;0;0;0;0;42173
2020-04-25;Soria;Todos;Personal en formación;25;2;1;1;42173
2020-04-25;Soria;Todos;Técnicos sanitarios;20;8;3;5;42173
2020-04-25;Valladolid;Todos;Enfermero/a;899;150;78;72;47186
2020-04-25;Valladolid;Todos;Otros;4;0;0;0;47186
2020-04-25;Valladolid;Todos;Servicios de apoyo no sanitario;43;8;4;4;47186
2020-04-25;Valladolid;Todos;Técnicos sanitarios;78;10;5;5;47186
2020-04-25;Zamora;Todos;Médicos;150;20;6;14;49275
2020-04-25;Zamora;Todos;Otros sanitarios;3;1;0;1;49275
2020-04-25;Zamora;Todos;Personal en formación;11;1;1;0;49275
2020-04-25;Zamora;Todos;Servicios de apoyo no sanitario;1;0;0;0;49275
2020-04-25;Zamora;Todos;Técnicos sanitarios;7;0;0;0;49275
2020-04-26;Ávila;Todos;Otros;1;1;0;1;5019
2020-04-26;Burgos;Todos;Administrativo;109;9;3;6;9059
2020-04-26;Burgos;Todos;Celador;74;14;5;9;9059
2020-04-26;León;Todos;Celador;173;19;8;11;24089
2020-04-26;León;Todos;Fisioterapeuta;16;2;0;2;24089
2020-04-26;León;Todos;Médicos;639;91;26;65;24089
2020-04-26;León;Todos;Técnicos sanitarios;49;7;2;5;24089
2020-04-26;Palencia;Todos;Celador;34;12;7;5;34120
2020-04-26;Palencia;Todos;Fisioterapeuta;6;1;1;0;34120
2020-04-26;Palencia;Todos;Médicos;160;28;10;18;34120
2020-04-26;Palencia;Todos;Otros sanitarios;7;1;0;1;34120
2020-04-26;Palencia;Todos;Servicios de apoyo no sanitario;14;3;1;2;34120
2020-04-26;Palencia;Todos;Técnicos sanitarios;9;3;2;1;34120
2020-04-26;Salamanca;Todos;Auxiliares sanitarios;224;80;39;41;37274
2020-04-26;Salamanca;Todos;Celador;67;25;12;13;37274
2020-04-26;Salamanca;Todos;Enfermero/a;435;122;49;73;37274
2020-04-26;Salamanca;Todos;Fisioterapeuta;6;4;1;3;37274
2020-04-26;Salamanca;Todos;Personal en formación;87;29;15;14;37274
2020-04-26;Salamanca;Todos;Técnicos sanitarios;39;16;6;10;37274
2020-04-26;Segovia;Todos;Celador;54;21;10;11;40004
2020-04-26;Segovia;Todos;Otros;0;0;0;0;40004
2020-04-26;Soria;Todos;Celador;51;11;3;8;42173
2020-04-26;Soria;Todos;Médicos;168;61;21;40;42173
2020-04-26;Valladolid;Todos;Celador;110;20;13;7;47186
2020-04-26;Valladolid;Todos;Fisioterapeuta;39;4;2;2;47186
2020-04-26;Valladolid;Todos;Médicos;831;114;33;81;47186
2020-04-26;Valladolid;Todos;Servicios de apoyo no sanitario;43;8;3;5;47186
2020-04-26;Zamora;Todos;Auxiliares sanitarios;69;6;5;1;49275
2020-04-26;Zamora;Todos;Celador;31;3;1;2;49275
2020-04-26;Zamora;Todos;Médicos;150;20;6;14;49275
2020-04-26;Zamora;Todos;Servicios de apoyo no sanitario;1;0;0;0;49275
2020-04-26;Zamora;Todos;Técnicos sanitarios;7;0;0;0;49275
2020-04-27;Ávila;Todos;Fisioterapeuta;7;0;0;0;5019
2020-04-27;Burgos;Todos;Administrativo;114;9;3;6;9059
2020-04-27;Burgos;Todos;Celador;77;14;4;10;9059
2020-04-27;Burgos;Todos;Otros sanitarios;18;0;0;0;9059
2020-04-27;Burgos;Todos;Personal en formación;49;5;1;4;9059
2020-04-27;Burgos;Todos;Servicios de apoyo no sanitario;20;3;2;1;9059
2020-04-27;Burgos;Todos;Técnicos sanitarios;46;4;0;4;9059
2020-04-27;León;Todos;Auxiliares sanitarios;334;59;28;31;24089
2020-04-27;León;Todos;Enfermero/a;891;144;70;74;24089
2020-04-27;León;Todos;Fisioterapeuta;18;2;0;2;24089
2020-04-27;León;Todos;Otros;6;0;0;0;24089
2020-04-27;Palencia;Todos;Enfermero/a;189;43;25;18;34120
2020-04-27;Palencia;Todos;Fisioterapeuta;6;1;1;0;34120
2020-04-27;Palencia;Todos;Servicios de apoyo no sanitario;14;3;1;2;34120
2020-04-27;Palencia;Todos;Técnicos sanitarios;9;3;2;1;34120
2020-04-27;Salamanca;Todos;Auxiliares sanitarios;226;81;39;42;37274
2020-04-27;Salamanca;Todos;Técnicos sanitarios;39;16;6;10;37274
2020-04-27;Segovia;Todos;Administrativo;59;18;6;12;40004
2020-04-27;Segovia;Todos;Fisioterapeuta;4;1;0;1;40004
2020-04-27;Segovia;Todos;Otros sanitarios;2;1;1;0;40004
2020-04-27;Segovia;Todos;Servicios de apoyo no sanitario;20;9;1;8;40004
2020-04-27;Soria;Todos;Administrativo;54;18;5;13;42173
2020-04-27;Soria;Todos;Auxiliares sanitarios;104;25;9;16;42173
2020-04-27;Soria;Todos;Enfermero/a;227;76;28;48;42173
2020-04-27;Soria;Todos;Otros sanitarios;6;3;2;1;42173
2020-04-27;Soria;Todos;Personal en formación;25;2;1;1;42173
2020-04-27;Valladolid;Todos;Administrativo;237;26;11;15;47186
2020-04-27;Valladolid;Todos;Enfermero/a;923;152;69;83;47186
2020-04-27;Valladolid;Todos;Otros sanitarios;21;4;0;4;47186
2020-04-27;Valladolid;Todos;Personal en formación;197;26;7;19;47186
2020-04-27;Valladolid;Todos;Servicios de apoyo no sanitario;46;8;3;5;47186
2020-04-27;Zamora;Todos;Administrativo;33;4;2;2;49275
2020-04-27;Zamora;Todos;Auxiliares sanitarios;89;6;5;1;49275
2020-04-27;Zamora;Todos;Médicos;171;19;5;14;49275
2020-04-27;Zamora;Todos;Otros;0;0;0;0;49275
2020-04-27;Zamora;Todos;Servicios de apoyo no sanitario;1;0;0;0;49275
2020-04-27;Zamora;Todos;Técnicos sanitarios;7;0;0;0;49275
2020-04-28;Ávila;Todos;Médicos;280;75;47;28;5019
2020-04-28;Ávila;Todos;Otros;1;1;0;1;5019
2020-04-28;Ávila;Todos;Otros sanitarios;15;6;6;0;5019
2020-04-28;Ávila;Todos;Personal en formación;28;4;2;2;5019
2020-04-28;Ávila;Todos;Servicios de apoyo no sanitario;22;9;8;1;5019
2020-04-28;Burgos;Todos;Celador;83;15;5;10;9059
2020-04-28;León;Todos;Fisioterapeuta;20;2;0;2;24089
2020-04-28;León;Todos;Médicos;688;93;24;69;24089
2020-04-28;León;Todos;Técnicos sanitarios;63;8;3;5;24089
2020-04-28;Palencia;Todos;Administrativo;59;5;3;2;34120
2020-04-28;Palencia;Todos;Fisioterapeuta;6;1;1;0;34120
2020-04-28;Palencia;Todos;Otros;4;1;1;0;34120
2020-04-28;Palencia;Todos;Otros sanitarios;7;1;0;1;34120
2020-04-28;Salamanca;Todos;Auxiliares sanitarios;227;82;37;45;37274
2020-04-28;Salamanca;Todos;Celador;68;25;11;14;37274
2020-04-28;Salamanca;Todos;Enfermero/a;447;124;48;76;37274
2020-04-28;Salamanca;Todos;Fisioterapeuta;7;4;1;3;37274
2020-04-28;Salamanca;Todos;Otros;4;3;3;0;37274
2020-04-28;Salamanca;Todos;Otros sanitarios;8;4;3;1;37274
2020-04-28;Segovia;Todos;Auxiliares sanitarios;153;51;14;37;40004
2020-04-28;Segovia;Todos;Otros;0;0;0;0;40004
2020-04-28;Segovia;Todos;Personal en formación;34;14;4;10;40004
2020-04-28;Segovia;Todos;Técnicos sanitarios;35;13;4;9;40004
2020-04-28;Soria;Todos;Celador;78;14;3;11;42173
2020-04-28;Soria;Todos;Enfermero/a;254;77;28;49;42173
2020-04-28;Soria;Todos;Médicos;203;62;22;40;42173
2020-04-28;Soria;Todos;Otros;0;0;0;0;42173
2020-04-28;Soria;Todos;Otros sanitarios;7;3;2;1;42173
2020-04-28;Soria;Todos;Personal en formación;26;2;1;1;42173
2020-04-28;Soria;Todos;Servicios de apoyo no sanitario;20;4;2;2;42173
2020-04-28;Valladolid;Todos;Administrativo;240;26;10;16;47186
2020-04-28;Valladolid;Todos;Médicos;853;117;34;83;47186
2020-04-28;Zamora;Todos;Enfermero/a;195;25;17;8;49275
2020-04-28;Zamora;Todos;Otros;0;0;0;0;49275
2020-04-28;Zamora;Todos;Técnicos sanitarios;7;0;0;0;49275
2020-04-29;Ávila;Todos;Auxiliares sanitarios;198;46;32;14;5019
2020-04-29;Ávila;Todos;Personal en formación;29;4;1;3;5019
2020-04-29;Burgos;Todos;Auxiliares sanitarios;322;48;24;24;9059
2020-04-29;Burgos;Todos;Celador;88;15;5;10;9059
2020-04-29;Burgos;Todos;Otros sanitarios;18;0;0;0;9059
2020-04-29;León;Todos;Auxiliares sanitarios;398;60;28;32;24089
2020-04-29;León;Todos;Celador;232;19;9;10;24089
2020-04-29;León;Todos;Personal en formación;130;17;3;14;24089
2020-04-29;Palencia;Todos;Auxiliares sanitarios;68;18;11;7;34120
2020-04-29;Palencia;Todos;Celador;34;12;7;5;34120
2020-04-29;Palencia;Todos;Enfermero/a;192;43;24;19;34120
2020-04-29;Palencia;Todos;Otros;4;1;1;0;34120
2020-04-29;Salamanca;Todos;Auxiliares sanitarios;245;85;36;49;37274
2020-04-29;Salamanca;Todos;Celador;82;25;8;17;37274
2020-04-29;Salamanca;Todos;Enfermero/a;593;135;49;86;37274
2020-04-29;Salamanca;Todos;Otros;4;3;3;0;37274
2020-04-29;Salamanca;Todos;Otros sanitarios;14;4;3;1;37274
2020-04-29;Salamanca;Todos;Servicios de apoyo no sanitario;36;14;4;10;37274
2020-04-29;Salamanca;Todos;Técnicos sanitarios;41;16;5;11;37274
2020-04-29;Segovia;Todos;Celador;77;25;9;16;40004
2020-04-29;Segovia;Todos;Otros sanitarios;6;4;2;2;40004
2020-04-29;Segovia;Todos;Personal en formación;41;16;6;10;40004
2020-04-29;Soria;Todos;Auxiliares sanitarios;119;26;10;16;42173
2020-04-29;Soria;Todos;Personal en formación;26;2;1;1;42173
2020-04-29;Soria;Todos;Servicios de apoyo no sanitario;21;4;1;3;42173
2020-04-29;Valladolid;Todos;Celador;117;22;12;10;47186
2020-04-29;Valladolid;Todos;Médicos;865;119;29;90;47186
2020-04-29;Valladolid;Todos;Otros;4;0;0;0;47186
2020-04-29;Valladolid;Todos;Servicios de apoyo no sanitario;49;8;3;5;47186
2020-04-29;Zamora;Todos;Administrativo;36;5;3;2;49275
2020-04-29;Zamora;Todos;Celador;50;3;1;2;49275
2020-04-29;Zamora;Todos;Médicos;195;18;5;13;49275
2020-04-29;Zamora;Todos;Personal en formación;22;1;1;0;49275
2020-04-29;Zamora;Todos;Servicios de apoyo no sanitario;1;0;0;0;49275
2020-04-30;Ávila;Todos;Administrativo;54;18;14;4;5019
2020-04-30;Ávila;Todos;Auxiliares sanitarios;199;45;31;14;5019
2020-04-30;Ávila;Todos;Enfermero/a;453;86;64;22;5019
2020-04-30;Ávila;Todos;Médicos;346;77;48;29;5019
2020-04-30;Ávila;Todos;Técnicos sanitarios;33;8;7;1;5019
2020-04-30;Burgos;Todos;Auxiliares sanitarios;333;48;23;25;9059
2020-04-30;Burgos;Todos;Celador;93;15;5;10;9059
2020-04-30;Burgos;Todos;Fisioterapeuta;21;2;1;1;9059
2020-04-30;Burgos;Todos;Otros;11;2;1;1;9059
2020-04-30;Burgos;Todos;Servicios de apoyo no sanitario;26;3;2;1;9059
2020-04-30;León;Todos;Auxiliares sanitarios;416;62;29;33;24089
2020-04-30;León;Todos;Enfermero/a;1042;147;51;96;24089
2020-04-30;León;Todos;Fisioterapeuta;22;2;1;1;24089
2020-04-30;León;Todos;Médicos;746;96;22;74;24089
2020-04-30;León;Todos;Otros sanitarios;28;3;0;3;24089
2020-04-30;León;Todos;Servicios de apoyo no sanitario;19;3;1;2;24089
2020-04-30;Palencia;Todos;Administrativo;59;5;1;4;34120
2020-04-30;Palencia;Todos;Auxiliares sanitarios;72;18;11;7;34120
2020-04-30;Palencia;Todos;Otros;4;1;1;0;34120
2020-04-30;Palencia;Todos;Otros sanitarios;7;1;0;1;34120
2020-04-30;Palencia;Todos;Personal en formación;19;6;0;6;34120
2020-04-30;Palencia;Todos;Servicios de apoyo no sanitario;14;3;1;2;34120
2020-04-30;Palencia;Todos;Técnicos sanitarios;9;3;1;2;34120
2020-04-30;Salamanca;Todos;Administrativo;131;24;12;12;37274
2020-04-30;Salamanca;Todos;Celador;86;25;7;18;37274
2020-04-30;Segovia;Todos;Celador;105;29;11;18;40004
2020-04-30;Segovia;Todos;Fisioterapeuta;8;2;1;1;40004
2020-04-30;Segovia;Todos;Médicos;297;90;22;68;40004
2020-04-30;Segovia;Todos;Otros sanitarios;7;4;2;2;40004
2020-04-30;Segovia;Todos;Servicios de apoyo no sanitario;22;9;0;9;40004
2020-04-30;Soria;Todos;Administrativo;71;18;5;13;42173
2020-04-30;Soria;Todos;Fisioterapeuta;8;1;0;1;42173
2020-04-30;Soria;Todos;Técnicos sanitarios;29;8;3;5;42173
2020-04-30;Valladolid;Todos;Auxiliares sanitarios;329;56;23;33;47186
2020-04-30;Valladolid;Todos;Médicos;855;115;26;89;47186
2020-04-30;Valladolid;Todos;Otros sanitarios;23;4;0;4;47186
2020-04-30;Valladolid;Todos;Personal en formación;201;25;5;20;47186
2020-04-30;Zamora;Todos;Enfermero/a;280;26;14;12;49275
2020-05-01;Ávila;Todos;Administrativo;55;18;14;4;5019
2020-05-01;Ávila;Todos;Enfermero/a;459;87;64;23;5019
2020-05-01;Ávila;Todos;Fisioterapeuta;14;0;0;0;5019
2020-05-01;Ávila;Todos;Otros sanitarios;15;6;5;1;5019
2020-05-01;Burgos;Todos;Auxiliares sanitarios;351;48;23;25;9059
2020-05-01;Burgos;Todos;Médicos;536;64;20;44;9059
2020-05-01;Burgos;Todos;Otros;11;2;1;1;9059
2020-05-01;León;Todos;Administrativo;154;14;5;9;24089
2020-05-01;León;Todos;Fisioterapeuta;22;2;1;1;24089
2020-05-01;León;Todos;Médicos;750;96;22;74;24089
2020-05-01;León;Todos;Técnicos sanitarios;65;8;3;5;24089
2020-05-01;Palencia;Todos;Celador;34;12;4;8;34120
2020-05-01;Palencia;Todos;Fisioterapeuta;6;1;1;0;34120
2020-05-01;Palencia;Todos;Otros sanitarios;7;1;0;1;34120
2020-05-01;Palencia;Todos;Técnicos sanitarios;9;3;1;2;34120
2020-05-01;Salamanca;Todos;Enfermero/a;684;140;48;92;37274
2020-05-01;Salamanca;Todos;Médicos;590;140;41;99;37274
2020-05-01;Salamanca;Todos;Personal en formación;109;31;14;17;37274
2020-05-01;Segovia;Todos;Otros sanitarios;7;4;2;2;40004
2020-05-01;Segovia;Todos;Personal en formación;48;17;5;12;40004
2020-05-01;Segovia;Todos;Servicios de apoyo no sanitario;22;9;0;9;40004
2020-05-01;Soria;Todos;Administrativo;71;18;5;13;42173
2020-05-01;Soria;Todos;Celador;84;14;2;12;42173
2020-05-01;Soria;Todos;Fisioterapeuta;8;1;0;1;42173
2020-05-01;Soria;Todos;Otros;0;0;0;0;42173
2020-05-01;Soria;Todos;Servicios de apoyo no sanitario;23;4;1;3;42173
2020-05-01;Soria;Todos;Técnicos sanitarios;30;8;3;5;42173
2020-05-01;Valladolid;Todos;Enfermero/a;991;155;50;105;47186
2020-05-01;Valladolid;Todos;Otros;4;0;0;0;47186
2020-05-01;Valladolid;Todos;Otros sanitarios;23;4;0;4;47186
2020-05-01;Zamora;Todos;Administrativo;45;5;2;3;49275
2020-05-01;Zamora;Todos;Otros;0;0;0;0;49275
2020-05-01;Zamora;Todos;Otros sanitarios;4;1;0;1;49275
2020-05-01;Zamora;Todos;Personal en formación;22;1;1;0;49275
2020-05-01;Zamora;Todos;Servicios de apoyo no sanitario;2;0;0;0;49275
2020-05-02;Ávila;Todos;Fisioterapeuta;14;0;0;0;5019
2020-05-02;Ávila;Todos;Otros;0;0;0;0;5019
2020-05-02;Ávila;Todos;Otros sanitarios;15;6;5;1;5019
2020-05-02;Ávila;Todos;Personal en formación;36;4;1;3;5019
2020-05-02;Ávila;Todos;Técnicos sanitarios;39;8;6;2;5019
2020-05-02;Burgos;Todos;Auxiliares sanitarios;352;51;24;27;9059
2020-05-02;Burgos;Todos;Enfermero/a;759;87;33;54;9059
2020-05-02;Burgos;Todos;Médicos;538;64;20;44;9059
2020-05-02;Burgos;Todos;Técnicos sanitarios;62;5;1;4;9059
2020-05-02;León;Todos;Auxiliares sanitarios;443;63;29;34;24089
2020-05-02;León;Todos;Enfermero/a;1100;149;50;99;24089
2020-05-02;León;Todos;Fisioterapeuta;30;2;1;1;24089
2020-05-02;León;Todos;Personal en formación;143;17;3;14;24089
2020-05-02;Palencia;Todos;Administrativo;60;5;1;4;34120
2020-05-02;Palencia;Todos;Fisioterapeuta;6;1;1;0;34120
2020-05-02;Palencia;Todos;Otros;4;1;1;0;34120
2020-05-02;Palencia;Todos;Personal en formación;19;6;0;6;34120
2020-05-02;Salamanca;Todos;Servicios de apoyo no sanitario;38;14;4;10;37274
2020-05-02;Salamanca;Todos;Técnicos sanitarios;46;16;4;12;37274
2020-05-02;Segovia;Todos;Enfermero/a;441;149;37;112;40004
2020-05-02;Segovia;Todos;Médicos;300;90;22;68;40004
2020-05-02;Segovia;Todos;Servicios de apoyo no sanitario;22;9;0;9;40004
2020-05-02;Soria;Todos;Auxiliares sanitarios;136;29;11;18;42173
2020-05-02;Soria;Todos;Servicios de apoyo no sanitario;23;4;1;3;42173
2020-05-02;Valladolid;Todos;Médicos;859;115;24;91;47186
2020-05-02;Valladolid;Todos;Personal en formación;202;25;5;20;47186
2020-05-02;Valladolid;Todos;Servicios de apoyo no sanitario;50;8;3;5;47186
2020-05-02;Zamora;Todos;Celador;56;4;2;2;49275
2020-05-02;Zamora;Todos;Médicos;250;22;10;12;49275
2020-05-02;Zamora;Todos;Personal en formación;22;1;1;0;49275
2020-05-03;Ávila;Todos;Administrativo;57;18;14;4;5019
2020-05-03;Ávila;Todos;Auxiliares sanitarios;227;47;31;16;5019
2020-05-03;Ávila;Todos;Celador;109;13;10;3;5019
2020-05-03;Ávila;Todos;Técnicos sanitarios;44;8;6;2;5019
2020-05-03;Burgos;Todos;Auxiliares sanitarios;352;51;24;27;9059
2020-05-03;Burgos;Todos;Celador;96;16;5;11;9059
2020-05-03;Burgos;Todos;Enfermero/a;761;87;33;54;9059
2020-05-03;Burgos;Todos;Fisioterapeuta;21;2;1;1;9059
2020-05-03;Burgos;Todos;Otros sanitarios;19;0;0;0;9059
2020-05-03;Burgos;Todos;Técnicos sanitarios;62;5;1;4;9059
2020-05-03;León;Todos;Administrativo;155;14;5;9;24089
2020-05-03;León;Todos;Fisioterapeuta;30;2;1;1;24089
2020-05-03;León;Todos;Médicos;753;97;20;77;24089
2020-05-03;León;Todos;Otros;6;0;0;0;24089
2020-05-03;León;Todos;Otros sanitarios;29;3;0;3;24089
2020-05-03;León;Todos;Personal en formación;143;17;4;13;24089
2020-05-03;León;Todos;Técnicos sanitarios;66;8;3;5;24089
2020-05-03;Palencia;Todos;Administrativo;60;5;1;4;34120
2020-05-03;Palencia;Todos;Otros sanitarios;7;1;0;1;34120
2020-05-03;Palencia;Todos;Personal en formación;20;6;0;6;34120
2020-05-03;Salamanca;Todos;Administrativo;133;24;12;12;37274
2020-05-03;Salamanca;Todos;Enfermero/a;694;141;46;95;37274
2020-05-03;Salamanca;Todos;Otros;4;3;2;1;37274
2020-05-03;Salamanca;Todos;Otros sanitarios;15;4;3;1;37274
2020-05-03;Salamanca;Todos;Personal en formación;113;33;13;20;37274
2020-05-03;Salamanca;Todos;Servicios de apoyo no sanitario;38;14;4;10;37274
2020-05-03;Salamanca;Todos;Técnicos sanitarios;46;16;4;12;37274
2020-05-03;Segovia;Todos;Médicos;300;90;22;68;40004
2020-05-03;Segovia;Todos;Servicios de apoyo no sanitario;22;9;0;9;40004
2020-05-03;Soria;Todos;Celador;84;14;2;12;42173
2020-05-03;Soria;Todos;Médicos;223;64;18;46;42173
2020-05-03;Valladolid;Todos;Administrativo;246;26;8;18;47186
2020-05-03;Valladolid;Todos;Médicos;860;115;24;91;47186
2020-05-03;Valladolid;Todos;Personal en formación;202;25;5;20;47186
2020-05-03;Valladolid;Todos;Técnicos sanitarios;94;11;4;7;47186
2020-05-03;Zamora;Todos;Celador;56;4;2;2;49275
2020-05-03;Zamora;Todos;Otros;0;0;0;0;49275
2020-05-03;Zamora;Todos;Personal en formación;22;1;1;0;49275
2020-05-04;Ávila;Todos;Enfermero/a;488;89;61;28;5019
2020-05-04;Ávila;Todos;Fisioterapeuta;14;0;0;0;5019
2020-05-04;Ávila;Todos;Médicos;363;81;43;38;5019
2020-05-04;Ávila;Todos;Otros sanitarios;15;5;4;1;5019
2020-05-04;Burgos;Todos;Auxiliares sanitarios;392;52;21;31;9059
2020-05-04;Burgos;Todos;Fisioterapeuta;21;2;1;1;9059
2020-05-04;Palencia;Todos;Enfermero/a;204;44;10;34;34120
2020-05-04;Palencia;Todos;Otros sanitarios;7;1;0;1;34120
2020-05-04;Palencia;Todos;Personal en formación;20;6;0;6;34120
2020-05-04;Palencia;Todos;Servicios de apoyo no sanitario;14;3;1;2;34120
2020-05-04;Salamanca;Todos;Auxiliares sanitarios;256;87;29;58;37274
2020-05-04;Salamanca;Todos;Celador;90;25;6;19;37274
2020-05-04;Salamanca;Todos;Fisioterapeuta;21;6;3;3;37274
2020-05-04;Salamanca;Todos;Médicos;620;145;47;98;37274
2020-05-04;Salamanca;Todos;Otros sanitarios;17;4;3;1;37274
2020-05-04;Salamanca;Todos;Personal en formación;117;32;13;19;37274
2020-05-04;Salamanca;Todos;Servicios de apoyo no sanitario;39;14;4;10;37274
2020-05-04;Segovia;Todos;Médicos;322;95;27;68;40004
2020-05-04;Segovia;Todos;Otros;0;0;0;0;40004
2020-05-04;Segovia;Todos;Servicios de apoyo no sanitario;25;9;0;9;40004
2020-05-04;Segovia;Todos;Técnicos sanitarios;41;13;3;10;40004
2020-05-04;Soria;Todos;Fisioterapeuta;8;2;0;2;42173
2020-05-04;Soria;Todos;Médicos;225;64;18;46;42173
2020-05-04;Valladolid;Todos;Celador;117;23;9;14;47186
2020-05-04;Valladolid;Todos;Médicos;836;110;22;88;47186
2020-05-04;Valladolid;Todos;Otros;5;0;0;0;47186
2020-05-04;Zamora;Todos;Fisioterapeuta;13;1;1;0;49275
2020-05-04;Zamora;Todos;Otros sanitarios;5;1;0;1;49275
2020-05-04;Zamora;Todos;Técnicos sanitarios;7;0;0;0;49275
2020-05-05;Ávila;Todos;Administrativo;59;19;15;4;5019
2020-05-05;Ávila;Todos;Enfermero/a;509;89;60;29;5019
2020-05-05;Ávila;Todos;Fisioterapeuta;14;0;0;0;5019
2020-05-05;Ávila;Todos;Otros;0;0;0;0;5019
2020-05-05;Ávila;Todos;Otros sanitarios;15;5;4;1;5019
2020-05-05;Ávila;Todos;Servicios de apoyo no sanitario;26;10;8;2;5019
2020-05-05;Burgos;Todos;Administrativo;141;9;3;6;9059
2020-05-05;Burgos;Todos;Celador;103;16;3;13;9059
2020-05-05;Burgos;Todos;Enfermero/a;907;90;28;62;9059
2020-05-05;Burgos;Todos;Fisioterapeuta;21;2;1;1;9059
2020-05-05;Burgos;Todos;Servicios de apoyo no sanitario;27;3;2;1;9059
2020-05-05;León;Todos;Celador;246;20;11;9;24089
2020-05-05;León;Todos;Enfermero/a;1113;148;46;102;24089
2020-05-05;León;Todos;Médicos;764;100;18;82;24089
2020-05-05;León;Todos;Otros;6;0;0;0;24089
2020-05-05;León;Todos;Otros sanitarios;29;3;0;3;24089
2020-05-05;León;Todos;Servicios de apoyo no sanitario;21;3;1;2;24089
2020-05-05;Palencia;Todos;Celador;35;12;2;10;34120
2020-05-05;Palencia;Todos;Personal en formación;20;6;0;6;34120
2020-05-05;Palencia;Todos;Servicios de apoyo no sanitario;15;3;1;2;34120
2020-05-05;Segovia;Todos;Auxiliares sanitarios;259;72;28;44;40004
2020-05-05;Segovia;Todos;Enfermero/a;532;166;55;111;40004
2020-05-05;Segovia;Todos;Otros sanitarios;10;4;2;2;40004
2020-05-05;Soria;Todos;Celador;92;14;1;13;42173
2020-05-05;Soria;Todos;Enfermero/a;358;92;29;63;42173
2020-05-05;Soria;Todos;Fisioterapeuta;8;2;0;2;42173
2020-05-05;Soria;Todos;Otros sanitarios;9;3;3;0;42173
2020-05-05;Soria;Todos;Servicios de apoyo no sanitario;49;6;2;4;42173
2020-05-05;Valladolid;Todos;Enfermero/a;1031;154;43;111;47186
2020-05-05;Valladolid;Todos;Médicos;853;110;20;90;47186
2020-05-05;Valladolid;Todos;Otros;5;0;0;0;47186
2020-05-05;Valladolid;Todos;Servicios de apoyo no sanitario;52;8;3;5;47186
2020-05-05;Valladolid;Todos;Técnicos sanitarios;99;10;3;7;47186
2020-05-05;Zamora;Todos;Administrativo;46;3;0;3;49275
2020-05-05;Zamora;Todos;Técnicos sanitarios;8;1;1;0;49275
2020-05-06;Ávila;Todos;Médicos;367;81;44;37;5019
2020-05-06;Ávila;Todos;Otros sanitarios;15;5;4;1;5019
2020-05-06;Ávila;Todos;Personal en formación;37;4;1;3;5019
2020-05-06;Ávila;Todos;Técnicos sanitarios;44;9;5;4;5019
2020-05-06;Burgos;Todos;Auxiliares sanitarios;489;59;19;40;9059
2020-05-06;Burgos;Todos;Enfermero/a;976;93;27;66;9059
2020-05-06;Burgos;Todos;Servicios de apoyo no sanitario;27;3;1;2;9059
2020-05-06;León;Todos;Administrativo;158;16;6;10;24089
2020-05-06;León;Todos;Auxiliares sanitarios;468;65;23;42;24089
2020-05-06;León;Todos;Celador;257;20;11;9;24089
2020-05-06;León;Todos;Otros;6;0;0;0;24089
2020-05-06;Palencia;Todos;Auxiliares sanitarios;94;18;6;12;34120
2020-05-06;Salamanca;Todos;Fisioterapeuta;23;6;2;4;37274
2020-05-06;Salamanca;Todos;Otros;5;4;3;1;37274
2020-05-06;Salamanca;Todos;Otros sanitarios;17;4;3;1;37274
2020-05-06;Salamanca;Todos;Servicios de apoyo no sanitario;41;14;2;12;37274
2020-05-06;Salamanca;Todos;Técnicos sanitarios;52;16;2;14;37274
2020-05-06;Segovia;Todos;Administrativo;113;25;11;14;40004
2020-05-06;Segovia;Todos;Celador;139;35;12;23;40004
2020-05-06;Segovia;Todos;Enfermero/a;551;170;65;105;40004
2020-05-06;Segovia;Todos;Médicos;352;102;28;74;40004
2020-05-06;Segovia;Todos;Otros sanitarios;10;4;2;2;40004
2020-05-06;Soria;Todos;Celador;96;14;1;13;42173
2020-05-06;Soria;Todos;Médicos;256;70;21;49;42173
2020-05-06;Soria;Todos;Técnicos sanitarios;46;11;3;8;42173
2020-05-06;Valladolid;Todos;Celador;118;23;8;15;47186
2020-05-06;Valladolid;Todos;Médicos;843;106;19;87;47186
2020-05-06;Valladolid;Todos;Otros sanitarios;24;4;0;4;47186
2020-05-06;Zamora;Todos;Celador;59;5;2;3;49275
2020-05-06;Zamora;Todos;Enfermero/a;340;30;13;17;49275
2020-05-06;Zamora;Todos;Otros;0;0;0;0;49275
2020-05-06;Zamora;Todos;Otros sanitarios;6;1;0;1;49275
2020-05-06;Zamora;Todos;Personal en formación;23;1;1;0;49275
2020-05-07;Ávila;Todos;Enfermero/a;517;90;58;32;5019
2020-05-07;Ávila;Todos;Médicos;369;81;45;36;5019
2020-05-07;Ávila;Todos;Otros;0;0;0;0;5019
2020-05-07;Ávila;Todos;Servicios de apoyo no sanitario;28;10;8;2;5019
2020-05-07;Burgos;Todos;Administrativo;150;10;2;8;9059
2020-05-07;Burgos;Todos;Fisioterapeuta;21;2;1;1;9059
2020-05-07;Burgos;Todos;Médicos;655;78;25;53;9059
2020-05-07;Burgos;Todos;Otros sanitarios;20;0;0;0;9059
2020-05-07;Burgos;Todos;Personal en formación;97;8;2;6;9059
2020-05-07;León;Todos;Enfermero/a;1175;146;39;107;24089
2020-05-07;León;Todos;Fisioterapeuta;31;2;1;1;24089
2020-05-07;León;Todos;Otros sanitarios;30;3;0;3;24089
2020-05-07;Palencia;Todos;Celador;44;13;2;11;34120
2020-05-07;Palencia;Todos;Médicos;221;32;2;30;34120
2020-05-07;Palencia;Todos;Técnicos sanitarios;18;3;0;3;34120
2020-05-07;Salamanca;Todos;Auxiliares sanitarios;268;91;31;60;37274
2020-05-07;Salamanca;Todos;Enfermero/a;738;144;41;103;37274
2020-05-07;Salamanca;Todos;Servicios de apoyo no sanitario;42;14;2;12;37274
2020-05-07;Segovia;Todos;Administrativo;128;27;11;16;40004
2020-05-07;Segovia;Todos;Auxiliares sanitarios;288;75;34;41;40004
2020-05-07;Segovia;Todos;Celador;156;38;13;25;40004
2020-05-07;Segovia;Todos;Otros;0;0;0;0;40004
2020-05-07;Segovia;Todos;Otros sanitarios;11;4;2;2;40004
2020-05-07;Soria;Todos;Auxiliares sanitarios;215;47;20;27;42173
2020-05-07;Soria;Todos;Médicos;272;74;26;48;42173
2020-05-07;Soria;Todos;Otros;0;0;0;0;42173
2020-05-07;Soria;Todos;Otros sanitarios;12;3;3;0;42173
2020-05-07;Valladolid;Todos;Auxiliares sanitarios;347;64;24;40;47186
2020-05-07;Valladolid;Todos;Enfermero/a;1035;159;40;119;47186
2020-05-07;Valladolid;Todos;Fisioterapeuta;42;4;2;2;47186
2020-05-07;Valladolid;Todos;Personal en formación;208;25;5;20;47186
2020-05-07;Valladolid;Todos;Servicios de apoyo no sanitario;51;9;2;7;47186
2020-05-07;Zamora;Todos;Auxiliares sanitarios;130;11;5;6;49275
2020-05-07;Zamora;Todos;Enfermero/a;338;28;16;12;49275
2020-05-07;Zamora;Todos;Fisioterapeuta;14;1;1;0;49275
2020-05-07;Zamora;Todos;Médicos;304;23;12;11;49275
2020-05-07;Zamora;Todos;Otros;0;0;0;0;49275
2020-05-07;Zamora;Todos;Otros sanitarios;6;1;0;1;49275
2020-05-07;Zamora;Todos;Técnicos sanitarios;11;1;1;0;49275
2020-05-08;Ávila;Todos;Auxiliares sanitarios;238;52;33;19;5019
2020-05-08;Ávila;Todos;Otros;0;0;0;0;5019
2020-05-08;Burgos;Todos;Auxiliares sanitarios;620;69;21;48;9059
2020-05-08;Burgos;Todos;Enfermero/a;1171;116;35;81;9059
2020-05-08;Burgos;Todos;Fisioterapeuta;21;2;1;1;9059
2020-05-08;Burgos;Todos;Médicos;725;84;26;58;9059
2020-05-08;Burgos;Todos;Otros sanitarios;20;0;0;0;9059
2020-05-08;Burgos;Todos;Servicios de apoyo no sanitario;34;3;1;2;9059
2020-05-08;León;Todos;Administrativo;161;19;7;12;24089
2020-05-08;León;Todos;Auxiliares sanitarios;502;70;23;47;24089
2020-05-08;León;Todos;Otros;6;0;0;0;24089
2020-05-08;León;Todos;Otros sanitarios;30;3;0;3;24089
2020-05-08;León;Todos;Técnicos sanitarios;71;7;3;4;24089
2020-05-08;Palencia;Todos;Administrativo;78;7;4;3;34120
2020-05-08;Palencia;Todos;Auxiliares sanitarios;99;19;6;13;34120
2020-05-08;Palencia;Todos;Enfermero/a;260;48;10;38;34120
2020-05-08;Palencia;Todos;Otros sanitarios;9;2;0;2;34120
2020-05-08;Palencia;Todos;Personal en formación;24;7;2;5;34120
2020-05-08;Palencia;Todos;Servicios de apoyo no sanitario;15;3;1;2;34120
2020-05-08;Palencia;Todos;Técnicos sanitarios;18;3;0;3;34120
2020-05-08;Salamanca;Todos;Auxiliares sanitarios;272;91;31;60;37274
2020-05-08;Salamanca;Todos;Celador;101;26;7;19;37274
2020-05-08;Salamanca;Todos;Técnicos sanitarios;56;18;3;15;37274
2020-05-08;Segovia;Todos;Médicos;390;108;38;70;40004
2020-05-08;Segovia;Todos;Otros sanitarios;11;4;2;2;40004
2020-05-08;Soria;Todos;Fisioterapeuta;15;2;0;2;42173
2020-05-08;Soria;Todos;Otros;0;0;0;0;42173
2020-05-08;Valladolid;Todos;Administrativo;251;28;11;17;47186
2020-05-08;Valladolid;Todos;Médicos;858;106;24;82;47186
2020-05-08;Valladolid;Todos;Otros sanitarios;23;4;0;4;47186
2020-05-08;Zamora;Todos;Otros sanitarios;6;1;0;1;49275
2020-05-08;Zamora;Todos;Servicios de apoyo no sanitario;2;0;0;0;49275
2020-05-09;Ávila;Todos;Enfermero/a;385;100;61;39;5019
2020-05-09;Ávila;Todos;Médicos;243;81;36;45;5019
2020-05-09;Ávila;Todos;Otros;1;1;0;1;5019
2020-05-09;Ávila;Todos;Técnicos sanitarios;32;10;4;6;5019
2020-05-09;Burgos;Todos;Auxiliares sanitarios;377;62;15;47;9059
2020-05-09;Burgos;Todos;Enfermero/a;620;97;14;83;9059
2020-05-09;Burgos;Todos;Fisioterapeuta;9;2;1;1;9059
2020-05-09;Burgos;Todos;Médicos;355;73;8;65;9059
2020-05-09;Burgos;Todos;Otros;3;2;1;1;9059
2020-05-09;Burgos;Todos;Otros sanitarios;15;0;0;0;9059
2020-05-09;León;Todos;Celador;138;23;8;15;24089
2020-05-09;León;Todos;Otros;5;0;0;0;24089
2020-05-09;León;Todos;Técnicos sanitarios;49;7;1;6;24089
2020-05-09;Palencia;Todos;Enfermero/a;141;47;5;42;34120
2020-05-09;Palencia;Todos;Personal en formación;21;7;1;6;34120
2020-05-09;Palencia;Todos;Servicios de apoyo no sanitario;10;5;1;4;34120
2020-05-09;Salamanca;Todos;Administrativo;66;23;7;16;37274
2020-05-09;Salamanca;Todos;Fisioterapeuta;11;6;1;5;37274
2020-05-09;Salamanca;Todos;Otros;3;2;1;1;37274
2020-05-09;Salamanca;Todos;Otros sanitarios;7;4;3;1;37274
2020-05-09;Salamanca;Todos;Técnicos sanitarios;42;17;2;15;37274
2020-05-09;Segovia;Todos;Administrativo;66;27;0;27;40004
2020-05-09;Segovia;Todos;Enfermero/a;321;162;7;155;40004
2020-05-09;Segovia;Todos;Otros sanitarios;5;3;1;2;40004
2020-05-09;Segovia;Todos;Personal en formación;37;20;2;18;40004
2020-05-09;Soria;Todos;Auxiliares sanitarios;81;41;9;32;42173
2020-05-09;Soria;Todos;Celador;24;12;0;12;42173
2020-05-09;Soria;Todos;Enfermero/a;148;92;12;80;42173
2020-05-09;Soria;Todos;Otros;0;0;0;0;42173
2020-05-09;Valladolid;Todos;Administrativo;144;34;4;30;47186
2020-05-09;Valladolid;Todos;Auxiliares sanitarios;381;67;20;47;47186
2020-05-09;Valladolid;Todos;Otros;5;0;0;0;47186
2020-05-09;Valladolid;Todos;Personal en formación;131;26;2;24;47186
2020-05-09;Valladolid;Todos;Servicios de apoyo no sanitario;70;12;1;11;47186
2020-05-09;Zamora;Todos;Celador;19;7;0;7;49275
2020-05-09;Zamora;Todos;Fisioterapeuta;2;1;0;1;49275
2020-05-09;Zamora;Todos;Personal en formación;5;0;0;0;49275
2020-05-09;Zamora;Todos;Técnicos sanitarios;7;0;0;0;49275
2020-05-10;Ávila;Todos;Auxiliares sanitarios;226;55;32;23;5019
2020-05-10;Ávila;Todos;Médicos;242;80;36;44;5019
2020-05-10;Ávila;Todos;Personal en formación;27;4;3;1;5019
2020-05-10;Ávila;Todos;Servicios de apoyo no sanitario;28;10;6;4;5019
2020-05-10;Ávila;Todos;Técnicos sanitarios;32;10;4;6;5019
2020-05-10;Burgos;Todos;Auxiliares sanitarios;377;62;14;48;9059
2020-05-10;León;Todos;Médicos;495;98;6;92;24089
2020-05-10;León;Todos;Otros sanitarios;17;3;0;3;24089
2020-05-10;León;Todos;Personal en formación;121;18;3;15;24089
2020-05-10;León;Todos;Técnicos sanitarios;49;7;1;6;24089
2020-05-10;Palencia;Todos;Servicios de apoyo no sanitario;10;3;1;2;34120
2020-05-10;Salamanca;Todos;Fisioterapeuta;12;6;1;5;37274
2020-05-10;Salamanca;Todos;Otros;3;2;1;1;37274
2020-05-10;Salamanca;Todos;Otros sanitarios;7;4;3;1;37274
2020-05-10;Salamanca;Todos;Personal en formación;82;30;6;24;37274
2020-05-10;Salamanca;Todos;Servicios de apoyo no sanitario;39;14;3;11;37274
2020-05-10;Segovia;Todos;Médicos;228;103;10;93;40004
2020-05-10;Segovia;Todos;Técnicos sanitarios;32;14;0;14;40004
2020-05-10;Soria;Todos;Enfermero/a;148;92;12;80;42173
2020-05-10;Soria;Todos;Otros;0;0;0;0;42173
2020-05-10;Soria;Todos;Otros sanitarios;4;2;0;2;42173
2020-05-10;Soria;Todos;Personal en formación;9;2;1;1;42173
2020-05-10;Soria;Todos;Servicios de apoyo no sanitario;8;5;0;5;42173
2020-05-10;Soria;Todos;Técnicos sanitarios;14;10;0;10;42173
2020-05-10;Valladolid;Todos;Administrativo;142;33;4;29;47186
2020-05-10;Valladolid;Todos;Auxiliares sanitarios;380;67;20;47;47186
2020-05-10;Valladolid;Todos;Celador;105;24;7;17;47186
2020-05-10;Valladolid;Todos;Enfermero/a;840;169;23;146;47186
2020-05-10;Valladolid;Todos;Médicos;601;124;10;114;47186
2020-05-10;Valladolid;Todos;Otros sanitarios;18;4;0;4;47186
2020-05-10;Valladolid;Todos;Técnicos sanitarios;84;13;0;13;47186
2020-05-10;Zamora;Todos;Enfermero/a;98;28;5;23;49275
2020-05-10;Zamora;Todos;Otros;0;0;0;0;49275
2020-05-11;Ávila;Todos;Administrativo;35;18;13;5;5019
2020-05-11;Ávila;Todos;Celador;110;16;6;10;5019
2020-05-11;Ávila;Todos;Enfermero/a;385;100;61;39;5019
2020-05-11;Ávila;Todos;Otros sanitarios;10;6;4;2;5019
2020-05-11;Ávila;Todos;Personal en formación;27;4;3;1;5019
2020-05-11;Burgos;Todos;Administrativo;61;9;0;9;9059
2020-05-11;Burgos;Todos;Auxiliares sanitarios;387;67;12;55;9059
2020-05-11;Burgos;Todos;Fisioterapeuta;9;2;1;1;9059
2020-05-11;Burgos;Todos;Otros;3;2;1;1;9059
2020-05-11;Burgos;Todos;Técnicos sanitarios;70;6;0;6;9059
2020-05-11;León;Todos;Administrativo;71;16;1;15;24089
2020-05-11;León;Todos;Otros sanitarios;17;3;0;3;24089
2020-05-11;León;Todos;Servicios de apoyo no sanitario;29;4;1;3;24089
2020-05-11;Palencia;Todos;Administrativo;16;7;1;6;34120
2020-05-11;Palencia;Todos;Médicos;124;32;2;30;34120
2020-05-11;Palencia;Todos;Otros sanitarios;6;2;0;2;34120
2020-05-11;Palencia;Todos;Personal en formación;21;7;1;6;34120
2020-05-11;Palencia;Todos;Servicios de apoyo no sanitario;8;2;0;2;34120
2020-05-11;Salamanca;Todos;Otros;3;2;1;1;37274
2020-05-11;Salamanca;Todos;Personal en formación;82;31;6;25;37274
2020-05-11;Segovia;Todos;Administrativo;67;27;0;27;40004
2020-05-11;Segovia;Todos;Auxiliares sanitarios;160;78;2;76;40004
2020-05-11;Segovia;Todos;Médicos;236;106;10;96;40004
2020-05-11;Segovia;Todos;Otros;0;0;0;0;40004
2020-05-11;Segovia;Todos;Servicios de apoyo no sanitario;24;11;1;10;40004
2020-05-11;Soria;Todos;Enfermero/a;151;93;12;81;42173
2020-05-11;Soria;Todos;Médicos;108;66;7;59;42173
2020-05-11;Valladolid;Todos;Celador;106;25;6;19;47186
2020-05-11;Valladolid;Todos;Enfermero/a;849;170;22;148;47186
2020-05-11;Valladolid;Todos;Fisioterapeuta;20;4;0;4;47186
2020-05-11;Valladolid;Todos;Médicos;605;125;10;115;47186
2020-05-11;Valladolid;Todos;Otros;5;0;0;0;47186
2020-05-11;Valladolid;Todos;Personal en formación;132;27;1;26;47186
2020-05-11;Zamora;Todos;Administrativo;15;7;0;7;49275
2020-05-11;Zamora;Todos;Enfermero/a;101;28;4;24;49275
2020-05-11;Zamora;Todos;Otros;0;0;0;0;49275
2020-05-11;Zamora;Todos;Servicios de apoyo no sanitario;3;0;0;0;49275
2020-05-12;Ávila;Todos;Celador;110;16;6;10;5019
2020-05-12;Ávila;Todos;Médicos;245;80;33;47;5019
2020-05-12;Ávila;Todos;Otros;1;1;0;1;5019
2020-05-12;Ávila;Todos;Técnicos sanitarios;32;12;4;8;5019
2020-05-12;Burgos;Todos;Auxiliares sanitarios;396;77;13;64;9059
2020-05-12;Burgos;Todos;Otros;3;2;1;1;9059
2020-05-12;León;Todos;Auxiliares sanitarios;420;74;12;62;24089
2020-05-12;León;Todos;Enfermero/a;840;149;20;129;24089
2020-05-12;León;Todos;Fisioterapeuta;19;2;1;1;24089
2020-05-12;León;Todos;Otros;5;0;0;0;24089
2020-05-12;León;Todos;Otros sanitarios;20;3;0;3;24089
2020-05-12;León;Todos;Personal en formación;125;18;2;16;24089
2020-05-12;Palencia;Todos;Celador;32;14;2;12;34120
2020-05-12;Palencia;Todos;Enfermero/a;141;46;4;42;34120
2020-05-12;Palencia;Todos;Servicios de apoyo no sanitario;8;2;0;2;34120
2020-05-12;Palencia;Todos;Técnicos sanitarios;11;3;0;3;34120
2020-05-12;Salamanca;Todos;Celador;82;25;5;20;37274
2020-05-12;Salamanca;Todos;Fisioterapeuta;12;6;1;5;37274
2020-05-12;Salamanca;Todos;Médicos;368;143;19;124;37274
2020-05-12;Salamanca;Todos;Otros sanitarios;7;4;3;1;37274
2020-05-12;Salamanca;Todos;Personal en formación;83;32;6;26;37274
2020-05-12;Segovia;Todos;Administrativo;67;28;0;28;40004
2020-05-12;Segovia;Todos;Enfermero/a;329;165;5;160;40004
2020-05-12;Segovia;Todos;Médicos;236;109;10;99;40004
2020-05-12;Segovia;Todos;Técnicos sanitarios;33;15;0;15;40004
2020-05-12;Soria;Todos;Enfermero/a;154;96;11;85;42173
2020-05-12;Soria;Todos;Fisioterapeuta;4;2;0;2;42173
2020-05-12;Soria;Todos;Técnicos sanitarios;14;10;0;10;42173
2020-05-12;Valladolid;Todos;Enfermero/a;869;171;18;153;47186
2020-05-12;Valladolid;Todos;Técnicos sanitarios;90;13;0;13;47186
2020-05-12;Zamora;Todos;Auxiliares sanitarios;43;15;2;13;49275
2020-05-12;Zamora;Todos;Enfermero/a;103;28;4;24;49275
2020-05-12;Zamora;Todos;Médicos;107;25;1;24;49275
2020-05-12;Zamora;Todos;Servicios de apoyo no sanitario;3;0;0;0;49275
2020-05-13;Ávila;Todos;Auxiliares sanitarios;226;41;30;11;5019
2020-05-13;Ávila;Todos;Fisioterapeuta;8;0;0;0;5019
2020-05-13;Ávila;Todos;Personal en formación;28;4;3;1;5019
2020-05-13;Burgos;Todos;Auxiliares sanitarios;407;51;15;36;9059
2020-05-13;Burgos;Todos;Otros sanitarios;15;0;0;0;9059
2020-05-13;Burgos;Todos;Personal en formación;49;5;0;5;9059
2020-05-13;Burgos;Todos;Técnicos sanitarios;74;5;0;5;9059
2020-05-13;León;Todos;Enfermero/a;862;121;19;102;24089
2020-05-13;León;Todos;Fisioterapeuta;19;2;1;1;24089
2020-05-13;León;Todos;Otros;5;0;0;0;24089
2020-05-13;León;Todos;Otros sanitarios;20;3;0;3;24089
2020-05-13;Palencia;Todos;Celador;35;13;3;10;34120
2020-05-13;Palencia;Todos;Enfermero/a;150;41;4;37;34120
2020-05-13;Palencia;Todos;Médicos;129;30;3;27;34120
2020-05-13;Palencia;Todos;Técnicos sanitarios;13;3;0;3;34120
2020-05-13;Salamanca;Todos;Celador;85;23;5;18;37274
2020-05-13;Salamanca;Todos;Fisioterapeuta;12;5;1;4;37274
2020-05-13;Salamanca;Todos;Médicos;370;120;19;101;37274
2020-05-13;Salamanca;Todos;Personal en formación;86;24;7;17;37274
2020-05-13;Segovia;Todos;Otros;0;0;0;0;40004
2020-05-13;Soria;Todos;Otros sanitarios;4;2;0;2;42173
2020-05-13;Soria;Todos;Personal en formación;9;2;1;1;42173
2020-05-13;Soria;Todos;Servicios de apoyo no sanitario;11;2;0;2;42173
2020-05-13;Valladolid;Todos;Administrativo;150;21;3;18;47186
2020-05-13;Valladolid;Todos;Celador;110;22;6;16;47186
2020-05-13;Valladolid;Todos;Fisioterapeuta;20;3;0;3;47186
2020-05-13;Valladolid;Todos;Otros;5;0;0;0;47186
2020-05-13;Valladolid;Todos;Otros sanitarios;18;4;0;4;47186
2020-05-13;Valladolid;Todos;Técnicos sanitarios;91;9;0;9;47186
2020-05-13;Zamora;Todos;Auxiliares sanitarios;45;5;1;4;49275
2020-05-13;Zamora;Todos;Celador;21;3;0;3;49275
2020-05-13;Zamora;Todos;Fisioterapeuta;2;0;0;0;49275
2020-05-13;Zamora;Todos;Servicios de apoyo no sanitario;3;0;0;0;49275
2020-05-13;Zamora;Todos;Técnicos sanitarios;9;0;0;0;49275
2020-05-14;Ávila;Todos;Auxiliares sanitarios;226;41;30;11;5019
2020-05-14;Ávila;Todos;Fisioterapeuta;8;0;0;0;5019
2020-05-14;Ávila;Todos;Otros;1;1;0;1;5019
2020-05-14;Ávila;Todos;Otros sanitarios;10;5;3;2;5019
2020-05-14;Ávila;Todos;Servicios de apoyo no sanitario;29;8;6;2;5019
2020-05-14;Burgos;Todos;Celador;94;14;2;12;9059
2020-05-14;Burgos;Todos;Fisioterapeuta;13;2;1;1;9059
2020-05-14;Burgos;Todos;Médicos;375;56;7;49;9059
2020-05-14;León;Todos;Celador;183;16;3;13;24089
2020-05-14;León;Todos;Fisioterapeuta;20;2;1;1;24089
2020-05-14;León;Todos;Personal en formación;127;15;2;13;24089
2020-05-14;Palencia;Todos;Administrativo;20;4;1;3;34120
2020-05-14;Palencia;Todos;Auxiliares sanitarios;94;19;2;17;34120
2020-05-14;Palencia;Todos;Celador;35;13;3;10;34120
2020-05-14;Palencia;Todos;Enfermero/a;152;41;4;37;34120
2020-05-14;Palencia;Todos;Fisioterapeuta;4;2;1;1;34120
2020-05-14;Palencia;Todos;Personal en formación;23;8;2;6;34120
2020-05-14;Palencia;Todos;Servicios de apoyo no sanitario;11;3;0;3;34120
2020-05-14;Palencia;Todos;Técnicos sanitarios;13;3;0;3;34120
2020-05-14;Salamanca;Todos;Administrativo;68;20;7;13;37274
2020-05-14;Salamanca;Todos;Médicos;372;119;17;102;37274
2020-05-14;Salamanca;Todos;Servicios de apoyo no sanitario;42;12;3;9;37274
2020-05-14;Segovia;Todos;Administrativo;68;16;0;16;40004
2020-05-14;Segovia;Todos;Auxiliares sanitarios;167;49;1;48;40004
2020-05-14;Segovia;Todos;Médicos;240;75;8;67;40004
2020-05-14;Segovia;Todos;Otros sanitarios;6;1;1;0;40004
2020-05-14;Segovia;Todos;Servicios de apoyo no sanitario;28;10;1;9;40004
2020-05-14;Soria;Todos;Médicos;113;52;7;45;42173
2020-05-14;Soria;Todos;Personal en formación;9;2;1;1;42173
2020-05-14;Valladolid;Todos;Auxiliares sanitarios;406;66;13;53;47186
2020-05-14;Valladolid;Todos;Celador;111;22;6;16;47186
2020-05-14;Valladolid;Todos;Otros sanitarios;18;4;0;4;47186
2020-05-14;Zamora;Todos;Celador;22;3;0;3;49275
2020-05-14;Zamora;Todos;Fisioterapeuta;2;0;0;0;49275
2020-05-14;Zamora;Todos;Médicos;109;19;2;17;49275
2020-05-14;Zamora;Todos;Personal en formación;7;0;0;0;49275
2020-05-14;Zamora;Todos;Servicios de apoyo no sanitario;3;0;0;0;49275
2020-05-14;Zamora;Todos;Técnicos sanitarios;9;0;0;0;49275
2020-05-15;Ávila;Todos;Fisioterapeuta;8;0;0;0;5019
2020-05-15;Ávila;Todos;Médicos;248;67;32;35;5019
2020-05-15;Ávila;Todos;Otros sanitarios;10;5;3;2;5019
2020-05-15;Ávila;Todos;Personal en formación;28;4;3;1;5019
2020-05-15;Burgos;Todos;Administrativo;78;9;1;8;9059
2020-05-15;Burgos;Todos;Auxiliares sanitarios;424;51;12;39;9059
2020-05-15;Burgos;Todos;Servicios de apoyo no sanitario;33;3;2;1;9059
2020-05-15;León;Todos;Administrativo;128;8;1;7;24089
2020-05-15;León;Todos;Auxiliares sanitarios;516;56;8;48;24089
2020-05-15;León;Todos;Celador;183;16;3;13;24089
2020-05-15;León;Todos;Técnicos sanitarios;53;6;1;5;24089
2020-05-15;Palencia;Todos;Administrativo;20;4;1;3;34120
2020-05-15;Palencia;Todos;Auxiliares sanitarios;94;19;2;17;34120
2020-05-15;Palencia;Todos;Otros;3;1;1;0;34120
2020-05-15;Palencia;Todos;Personal en formación;23;8;2;6;34120
2020-05-15;Palencia;Todos;Técnicos sanitarios;13;3;0;3;34120
2020-05-15;Salamanca;Todos;Enfermero/a;456;119;23;96;37274
2020-05-15;Salamanca;Todos;Médicos;378;119;17;102;37274
2020-05-15;Salamanca;Todos;Otros;6;2;1;1;37274
2020-05-15;Salamanca;Todos;Otros sanitarios;8;4;3;1;37274
2020-05-15;Salamanca;Todos;Servicios de apoyo no sanitario;45;12;3;9;37274
2020-05-15;Segovia;Todos;Administrativo;68;16;0;16;40004
2020-05-15;Segovia;Todos;Otros;0;0;0;0;40004
2020-05-15;Segovia;Todos;Servicios de apoyo no sanitario;29;10;1;9;40004
2020-05-15;Soria;Todos;Enfermero/a;164;64;11;53;42173
2020-05-15;Soria;Todos;Fisioterapeuta;4;1;0;1;42173
2020-05-15;Soria;Todos;Otros;0;0;0;0;42173
2020-05-15;Soria;Todos;Otros sanitarios;5;2;0;2;42173
2020-05-15;Valladolid;Todos;Celador;112;22;6;16;47186
2020-05-15;Valladolid;Todos;Enfermero/a;886;148;14;134;47186
2020-05-15;Valladolid;Todos;Personal en formación;134;22;1;21;47186
2020-05-15;Zamora;Todos;Auxiliares sanitarios;49;5;1;4;49275
2020-05-15;Zamora;Todos;Celador;25;3;0;3;49275
2020-05-15;Zamora;Todos;Médicos;112;20;3;17;49275
2020-05-15;Zamora;Todos;Otros sanitarios;4;1;0;1;49275
2020-05-16;Ávila;Todos;Fisioterapeuta;8;0;0;0;5019
2020-05-16;Ávila;Todos;Servicios de apoyo no sanitario;29;8;6;2;5019
2020-05-16;Burgos;Todos;Servicios de apoyo no sanitario;33;3;2;1;9059
2020-05-16;Burgos;Todos;Técnicos sanitarios;79;5;0;5;9059
2020-05-16;León;Todos;Administrativo;130;8;1;7;24089
2020-05-16;León;Todos;Auxiliares sanitarios;519;56;8;48;24089
2020-05-16;León;Todos;Celador;184;16;3;13;24089
2020-05-16;León;Todos;Otros sanitarios;20;3;0;3;24089
2020-05-16;León;Todos;Técnicos sanitarios;53;6;1;5;24089
2020-05-16;Palencia;Todos;Médicos;134;30;3;27;34120
2020-05-16;Palencia;Todos;Otros;3;1;1;0;34120
2020-05-16;Palencia;Todos;Otros sanitarios;6;1;0;1;34120
2020-05-16;Salamanca;Todos;Fisioterapeuta;12;5;1;4;37274
2020-05-16;Salamanca;Todos;Otros sanitarios;8;4;3;1;37274
2020-05-16;Salamanca;Todos;Servicios de apoyo no sanitario;45;12;3;9;37274
2020-05-16;Segovia;Todos;Administrativo;69;16;0;16;40004
2020-05-16;Segovia;Todos;Fisioterapeuta;4;1;0;1;40004
2020-05-16;Segovia;Todos;Otros;0;0;0;0;40004
2020-05-16;Segovia;Todos;Otros sanitarios;6;1;1;0;40004
2020-05-16;Soria;Todos;Celador;26;9;0;9;42173
2020-05-16;Soria;Todos;Médicos;115;52;7;45;42173
2020-05-16;Valladolid;Todos;Administrativo;154;22;3;19;47186
2020-05-16;Valladolid;Todos;Auxiliares sanitarios;409;66;11;55;47186
2020-05-16;Valladolid;Todos;Enfermero/a;887;148;13;135;47186
2020-05-16;Valladolid;Todos;Fisioterapeuta;24;3;0;3;47186
2020-05-16;Valladolid;Todos;Otros sanitarios;18;4;0;4;47186
2020-05-16;Zamora;Todos;Celador;25;3;0;3;49275
2020-05-16;Zamora;Todos;Médicos;112;20;3;17;49275
2020-05-16;Zamora;Todos;Servicios de apoyo no sanitario;4;0;0;0;49275
2020-05-16;Zamora;Todos;Técnicos sanitarios;11;0;0;0;49275
2020-05-17;Ávila;Todos;Administrativo;35;15;13;2;5019
2020-05-17;Ávila;Todos;Auxiliares sanitarios;228;42;29;13;5019
2020-05-17;Ávila;Todos;Fisioterapeuta;8;0;0;0;5019
2020-05-17;Ávila;Todos;Servicios de apoyo no sanitario;29;8;6;2;5019
2020-05-17;Burgos;Todos;Auxiliares sanitarios;428;52;13;39;9059
2020-05-17;Burgos;Todos;Personal en formación;52;5;0;5;9059
2020-05-17;Burgos;Todos;Servicios de apoyo no sanitario;34;3;2;1;9059
2020-05-17;León;Todos;Administrativo;130;8;1;7;24089
2020-05-17;León;Todos;Médicos;583;80;5;75;24089
2020-05-17;León;Todos;Servicios de apoyo no sanitario;83;4;2;2;24089
2020-05-17;León;Todos;Técnicos sanitarios;53;6;1;5;24089
2020-05-17;Palencia;Todos;Auxiliares sanitarios;94;19;2;17;34120
2020-05-17;Palencia;Todos;Médicos;135;30;3;27;34120
2020-05-17;Palencia;Todos;Técnicos sanitarios;13;3;0;3;34120
2020-05-17;Salamanca;Todos;Administrativo;69;20;6;14;37274
2020-05-17;Salamanca;Todos;Celador;93;23;4;19;37274
2020-05-17;Salamanca;Todos;Otros;6;2;1;1;37274
2020-05-17;Salamanca;Todos;Técnicos sanitarios;44;16;1;15;37274
2020-05-17;Segovia;Todos;Celador;82;21;1;20;40004
2020-05-17;Segovia;Todos;Fisioterapeuta;4;1;0;1;40004
2020-05-17;Segovia;Todos;Personal en formación;41;13;1;12;40004
2020-05-17;Soria;Todos;Auxiliares sanitarios;88;26;5;21;42173
2020-05-17;Soria;Todos;Celador;26;9;0;9;42173
2020-05-17;Soria;Todos;Fisioterapeuta;4;1;0;1;42173
2020-05-17;Soria;Todos;Médicos;115;52;7;45;42173
2020-05-17;Soria;Todos;Otros sanitarios;5;2;0;2;42173
2020-05-17;Soria;Todos;Personal en formación;9;2;1;1;42173
2020-05-17;Valladolid;Todos;Fisioterapeuta;24;3;0;3;47186
2020-05-17;Valladolid;Todos;Otros;5;0;0;0;47186
2020-05-17;Zamora;Todos;Celador;25;3;0;3;49275
2020-05-17;Zamora;Todos;Médicos;112;20;3;17;49275
2020-05-18;Ávila;Todos;Celador;110;10;7;3;5019
2020-05-18;Ávila;Todos;Médicos;253;67;31;36;5019
2020-05-18;Ávila;Todos;Servicios de apoyo no sanitario;29;8;6;2;5019
2020-05-18;Burgos;Todos;Celador;103;14;1;13;9059
2020-05-18;Burgos;Todos;Médicos;388;56;6;50;9059
2020-05-18;Burgos;Todos;Otros;3;1;1;0;9059
2020-05-18;Burgos;Todos;Personal en formación;53;5;0;5;9059
2020-05-18;Burgos;Todos;Técnicos sanitarios;81;5;0;5;9059
2020-05-18;León;Todos;Administrativo;139;8;1;7;24089
2020-05-18;León;Todos;Fisioterapeuta;21;2;0;2;24089
2020-05-18;Palencia;Todos;Otros sanitarios;6;1;0;1;34120
2020-05-18;Palencia;Todos;Técnicos sanitarios;13;3;0;3;34120
2020-05-18;Salamanca;Todos;Auxiliares sanitarios;272;81;12;69;37274
2020-05-18;Salamanca;Todos;Celador;96;23;3;20;37274
2020-05-18;Salamanca;Todos;Enfermero/a;463;119;23;96;37274
2020-05-18;Salamanca;Todos;Servicios de apoyo no sanitario;47;12;3;9;37274
2020-05-18;Segovia;Todos;Auxiliares sanitarios;169;49;1;48;40004
2020-05-18;Segovia;Todos;Enfermero/a;339;122;3;119;40004
2020-05-18;Soria;Todos;Enfermero/a;168;64;10;54;42173
2020-05-18;Soria;Todos;Otros;0;0;0;0;42173
2020-05-18;Soria;Todos;Servicios de apoyo no sanitario;15;2;0;2;42173
2020-05-18;Valladolid;Todos;Médicos;626;100;6;94;47186
2020-05-18;Zamora;Todos;Personal en formación;8;0;0;0;49275
2020-05-18;Zamora;Todos;Servicios de apoyo no sanitario;5;0;0;0;49275
2020-05-18;Zamora;Todos;Técnicos sanitarios;11;0;0;0;49275
2020-05-19;Ávila;Todos;Fisioterapeuta;8;0;0;0;5019
2020-05-19;Ávila;Todos;Otros sanitarios;10;5;3;2;5019
2020-05-19;Burgos;Todos;Enfermero/a;740;81;7;74;9059
2020-05-19;León;Todos;Celador;216;16;2;14;24089
2020-05-19;León;Todos;Fisioterapeuta;25;2;0;2;24089
2020-05-19;León;Todos;Personal en formación;131;15;2;13;24089
2020-05-19;León;Todos;Servicios de apoyo no sanitario;84;4;1;3;24089
2020-05-19;Palencia;Todos;Administrativo;21;4;1;3;34120
2020-05-19;Palencia;Todos;Auxiliares sanitarios;96;20;3;17;34120
2020-05-19;Palencia;Todos;Celador;38;13;3;10;34120
2020-05-19;Salamanca;Todos;Celador;96;23;2;21;37274
2020-05-19;Salamanca;Todos;Enfermero/a;463;119;23;96;37274
2020-05-19;Salamanca;Todos;Otros;6;2;1;1;37274
2020-05-19;Segovia;Todos;Enfermero/a;342;122;3;119;40004
2020-05-19;Segovia;Todos;Fisioterapeuta;4;1;0;1;40004
2020-05-19;Segovia;Todos;Personal en formación;41;13;1;12;40004
2020-05-19;Segovia;Todos;Servicios de apoyo no sanitario;29;10;1;9;40004
2020-05-19;Soria;Todos;Auxiliares sanitarios;91;26;5;21;42173
2020-05-19;Soria;Todos;Servicios de apoyo no sanitario;15;2;0;2;42173
2020-05-19;Valladolid;Todos;Administrativo;157;22;2;20;47186
2020-05-19;Valladolid;Todos;Auxiliares sanitarios;423;67;7;60;47186
2020-05-19;Valladolid;Todos;Enfermero/a;906;149;13;136;47186
2020-05-19;Valladolid;Todos;Otros;5;0;0;0;47186
2020-05-19;Valladolid;Todos;Otros sanitarios;18;4;0;4;47186
2020-05-19;Valladolid;Todos;Personal en formación;138;22;0;22;47186
2020-05-19;Zamora;Todos;Celador;29;3;0;3;49275
2020-05-19;Zamora;Todos;Personal en formación;8;0;0;0;49275
2020-05-20;Ávila;Todos;Celador;110;10;7;3;5019
2020-05-20;Ávila;Todos;Fisioterapeuta;8;0;0;0;5019
2020-05-20;Ávila;Todos;Médicos;255;67;31;36;5019
2020-05-20;Burgos;Todos;Auxiliares sanitarios;509;52;11;41;9059
2020-05-20;Burgos;Todos;Enfermero/a;807;82;8;74;9059
2020-05-20;Burgos;Todos;Otros;3;1;1;0;9059
2020-05-20;Burgos;Todos;Servicios de apoyo no sanitario;41;4;2;2;9059
2020-05-20;León;Todos;Celador;233;17;2;15;24089
2020-05-20;León;Todos;Personal en formación;134;15;2;13;24089
2020-05-20;León;Todos;Servicios de apoyo no sanitario;84;4;1;3;24089
2020-05-20;Palencia;Todos;Administrativo;21;4;1;3;34120
2020-05-20;Palencia;Todos;Auxiliares sanitarios;97;20;3;17;34120
2020-05-20;Palencia;Todos;Celador;38;13;2;11;34120
2020-05-20;Palencia;Todos;Otros;4;1;1;0;34120
2020-05-20;Salamanca;Todos;Enfermero/a;471;119;23;96;37274
2020-05-20;Salamanca;Todos;Servicios de apoyo no sanitario;54;12;2;10;37274
2020-05-20;Salamanca;Todos;Técnicos sanitarios;47;16;1;15;37274
2020-05-20;Segovia;Todos;Enfermero/a;342;122;2;120;40004
2020-05-20;Segovia;Todos;Médicos;244;75;8;67;40004
2020-05-20;Segovia;Todos;Otros;0;0;0;0;40004
2020-05-20;Segovia;Todos;Personal en formación;41;13;1;12;40004
2020-05-20;Soria;Todos;Enfermero/a;169;64;10;54;42173
2020-05-20;Soria;Todos;Fisioterapeuta;4;1;0;1;42173
2020-05-20;Soria;Todos;Médicos;117;52;6;46;42173
2020-05-20;Valladolid;Todos;Administrativo;159;22;2;20;47186
2020-05-20;Valladolid;Todos;Celador;128;23;7;16;47186
2020-05-20;Valladolid;Todos;Enfermero/a;930;149;13;136;47186
2020-05-20;Valladolid;Todos;Fisioterapeuta;24;3;0;3;47186
2020-05-20;Valladolid;Todos;Otros;5;0;0;0;47186
2020-05-20;Valladolid;Todos;Personal en formación;139;22;0;22;47186
2020-05-20;Valladolid;Todos;Técnicos sanitarios;95;9;0;9;47186
2020-05-20;Zamora;Todos;Enfermero/a;116;21;2;19;49275
2020-05-20;Zamora;Todos;Médicos;123;20;2;18;49275
2020-05-21;Ávila;Todos;Celador;110;10;7;3;5019
2020-05-21;Ávila;Todos;Enfermero/a;395;85;58;27;5019
2020-05-21;Ávila;Todos;Médicos;255;67;31;36;5019
2020-05-21;Ávila;Todos;Otros;3;1;0;1;5019
2020-05-21;Burgos;Todos;Auxiliares sanitarios;513;52;11;41;9059
2020-05-21;Burgos;Todos;Fisioterapeuta;18;2;0;2;9059
2020-05-21;León;Todos;Otros sanitarios;20;3;0;3;24089
2020-05-21;León;Todos;Personal en formación;141;15;1;14;24089
2020-05-21;León;Todos;Técnicos sanitarios;185;7;2;5;24089
2020-05-21;Palencia;Todos;Celador;38;13;2;11;34120
2020-05-21;Palencia;Todos;Fisioterapeuta;5;2;0;2;34120
2020-05-21;Palencia;Todos;Personal en formación;25;8;2;6;34120
2020-05-21;Palencia;Todos;Técnicos sanitarios;13;3;0;3;34120
2020-05-21;Salamanca;Todos;Auxiliares sanitarios;283;81;8;73;37274
2020-05-21;Salamanca;Todos;Médicos;391;120;15;105;37274
2020-05-21;Salamanca;Todos;Otros sanitarios;9;4;3;1;37274
2020-05-21;Salamanca;Todos;Personal en formación;97;24;6;18;37274
2020-05-21;Salamanca;Todos;Servicios de apoyo no sanitario;55;12;1;11;37274
2020-05-21;Segovia;Todos;Administrativo;69;16;0;16;40004
2020-05-21;Segovia;Todos;Otros sanitarios;6;1;1;0;40004
2020-05-21;Soria;Todos;Otros;0;0;0;0;42173
2020-05-21;Soria;Todos;Servicios de apoyo no sanitario;15;2;0;2;42173
2020-05-21;Valladolid;Todos;Enfermero/a;931;149;13;136;47186
2020-05-21;Valladolid;Todos;Médicos;639;100;4;96;47186
2020-05-21;Valladolid;Todos;Personal en formación;139;22;0;22;47186
2020-05-21;Zamora;Todos;Auxiliares sanitarios;53;5;1;4;49275
2020-05-21;Zamora;Todos;Fisioterapeuta;4;0;0;0;49275
2020-05-22;Ávila;Todos;Auxiliares sanitarios;228;42;25;17;5019
2020-05-22;Ávila;Todos;Enfermero/a;396;85;58;27;5019
2020-05-22;Ávila;Todos;Otros;3;1;0;1;5019
2020-05-22;Ávila;Todos;Otros sanitarios;10;5;3;2;5019
2020-05-22;Ávila;Todos;Técnicos sanitarios;32;5;3;2;5019
2020-05-22;Burgos;Todos;Enfermero/a;836;82;7;75;9059
2020-05-22;Burgos;Todos;Fisioterapeuta;18;2;0;2;9059
2020-05-22;Burgos;Todos;Médicos;439;57;7;50;9059
2020-05-22;Burgos;Todos;Otros sanitarios;18;0;0;0;9059
2020-05-22;Burgos;Todos;Personal en formación;74;5;0;5;9059
2020-05-22;Burgos;Todos;Servicios de apoyo no sanitario;46;4;2;2;9059
2020-05-22;León;Todos;Enfermero/a;1111;125;13;112;24089
2020-05-22;León;Todos;Fisioterapeuta;33;2;0;2;24089
2020-05-22;León;Todos;Personal en formación;144;15;1;14;24089
2020-05-22;Palencia;Todos;Enfermero/a;167;42;4;38;34120
2020-05-22;Palencia;Todos;Fisioterapeuta;5;2;0;2;34120
2020-05-22;Salamanca;Todos;Fisioterapeuta;13;5;1;4;37274
2020-05-22;Salamanca;Todos;Médicos;393;120;15;105;37274
2020-05-22;Salamanca;Todos;Otros sanitarios;9;4;3;1;37274
2020-05-22;Salamanca;Todos;Personal en formación;99;24;6;18;37274
2020-05-22;Segovia;Todos;Celador;84;21;1;20;40004
2020-05-22;Soria;Todos;Administrativo;44;14;5;9;42173
2020-05-22;Soria;Todos;Auxiliares sanitarios;92;26;4;22;42173
2020-05-22;Soria;Todos;Fisioterapeuta;4;1;0;1;42173
2020-05-22;Soria;Todos;Médicos;117;52;6;46;42173
2020-05-22;Soria;Todos;Servicios de apoyo no sanitario;15;2;0;2;42173
2020-05-22;Valladolid;Todos;Celador;132;23;6;17;47186
2020-05-22;Valladolid;Todos;Fisioterapeuta;24;3;0;3;47186
2020-05-22;Valladolid;Todos;Personal en formación;139;22;0;22;47186
2020-05-22;Valladolid;Todos;Técnicos sanitarios;100;9;0;9;47186
2020-05-22;Zamora;Todos;Auxiliares sanitarios;53;5;1;4;49275
2020-05-22;Zamora;Todos;Enfermero/a;122;21;2;19;49275
2020-05-22;Zamora;Todos;Fisioterapeuta;4;0;0;0;49275
2020-05-22;Zamora;Todos;Médicos;127;20;2;18;49275
2020-05-23;Ávila;Todos;Celador;110;10;7;3;5019
2020-05-23;Ávila;Todos;Enfermero/a;396;85;58;27;5019
2020-05-23;Ávila;Todos;Médicos;255;67;30;37;5019
2020-05-23;Ávila;Todos;Servicios de apoyo no sanitario;29;8;6;2;5019
2020-05-23;Burgos;Todos;Auxiliares sanitarios;533;52;11;41;9059
2020-05-23;Burgos;Todos;Celador;124;15;2;13;9059
2020-05-23;Burgos;Todos;Enfermero/a;857;82;7;75;9059
2020-05-23;Burgos;Todos;Otros;4;1;1;0;9059
2020-05-23;Burgos;Todos;Servicios de apoyo no sanitario;46;4;2;2;9059
2020-05-23;León;Todos;Administrativo;166;9;2;7;24089
2020-05-23;León;Todos;Auxiliares sanitarios;637;58;4;54;24089
2020-05-23;León;Todos;Celador;258;17;2;15;24089
2020-05-23;León;Todos;Enfermero/a;1112;125;12;113;24089
2020-05-23;León;Todos;Médicos;687;80;2;78;24089
2020-05-23;León;Todos;Otros;6;0;0;0;24089
2020-05-23;Palencia;Todos;Celador;38;12;1;11;34120
2020-05-23;Palencia;Todos;Otros;4;1;1;0;34120
2020-05-23;Palencia;Todos;Técnicos sanitarios;13;3;0;3;34120
2020-05-23;Salamanca;Todos;Administrativo;83;20;5;15;37274
2020-05-23;Salamanca;Todos;Auxiliares sanitarios;288;81;8;73;37274
2020-05-23;Salamanca;Todos;Enfermero/a;487;120;22;98;37274
2020-05-23;Salamanca;Todos;Otros;6;2;0;2;37274
2020-05-23;Salamanca;Todos;Servicios de apoyo no sanitario;57;12;1;11;37274
2020-05-23;Salamanca;Todos;Técnicos sanitarios;49;16;1;15;37274
2020-05-23;Segovia;Todos;Auxiliares sanitarios;173;49;0;49;40004
2020-05-23;Segovia;Todos;Celador;84;21;1;20;40004
2020-05-23;Segovia;Todos;Enfermero/a;342;122;2;120;40004
2020-05-23;Segovia;Todos;Fisioterapeuta;4;1;0;1;40004
2020-05-23;Segovia;Todos;Médicos;248;75;8;67;40004
2020-05-23;Segovia;Todos;Personal en formación;41;13;1;12;40004
2020-05-23;Soria;Todos;Auxiliares sanitarios;92;26;4;22;42173
2020-05-23;Soria;Todos;Médicos;117;52;6;46;42173
2020-05-23;Soria;Todos;Otros;0;0;0;0;42173
2020-05-23;Soria;Todos;Otros sanitarios;5;2;0;2;42173
2020-05-23;Soria;Todos;Servicios de apoyo no sanitario;15;2;0;2;42173
2020-05-23;Valladolid;Todos;Auxiliares sanitarios;456;68;4;64;47186
2020-05-23;Valladolid;Todos;Celador;132;23;6;17;47186
2020-05-23;Valladolid;Todos;Fisioterapeuta;24;3;0;3;47186
2020-05-23;Zamora;Todos;Administrativo;23;1;0;1;49275
2020-05-23;Zamora;Todos;Fisioterapeuta;4;0;0;0;49275
2020-05-23;Zamora;Todos;Médicos;127;20;2;18;49275
2020-05-23;Zamora;Todos;Otros sanitarios;5;1;1;0;49275
2020-05-23;Zamora;Todos;Servicios de apoyo no sanitario;5;0;0;0;49275
2020-05-23;Zamora;Todos;Técnicos sanitarios;12;0;0;0;49275
2020-05-24;Ávila;Todos;Administrativo;35;15;13;2;5019
2020-05-24;Ávila;Todos;Médicos;255;67;30;37;5019
2020-05-24;Ávila;Todos;Otros sanitarios;10;5;3;2;5019
2020-05-24;Ávila;Todos;Personal en formación;28;4;3;1;5019
2020-05-24;Ávila;Todos;Servicios de apoyo no sanitario;29;8;6;2;5019
2020-05-24;Burgos;Todos;Enfermero/a;857;82;5;77;9059
2020-05-24;Burgos;Todos;Personal en formación;74;5;0;5;9059
2020-05-24;Burgos;Todos;Servicios de apoyo no sanitario;46;4;1;3;9059
2020-05-24;León;Todos;Otros;6;0;0;0;24089
2020-05-24;León;Todos;Otros sanitarios;20;3;0;3;24089
2020-05-24;Palencia;Todos;Auxiliares sanitarios;98;21;5;16;34120
2020-05-24;Palencia;Todos;Enfermero/a;168;42;4;38;34120
2020-05-24;Palencia;Todos;Fisioterapeuta;5;2;0;2;34120
2020-05-24;Palencia;Todos;Técnicos sanitarios;13;3;0;3;34120
2020-05-24;Salamanca;Todos;Auxiliares sanitarios;292;81;8;73;37274
2020-05-24;Salamanca;Todos;Celador;101;23;2;21;37274
2020-05-24;Salamanca;Todos;Enfermero/a;488;120;22;98;37274
2020-05-24;Salamanca;Todos;Fisioterapeuta;13;5;1;4;37274
2020-05-24;Salamanca;Todos;Médicos;394;120;15;105;37274
2020-05-24;Segovia;Todos;Enfermero/a;342;122;2;120;40004
2020-05-24;Segovia;Todos;Otros sanitarios;6;1;1;0;40004
2020-05-24;Segovia;Todos;Técnicos sanitarios;34;13;0;13;40004
2020-05-24;Soria;Todos;Auxiliares sanitarios;92;26;4;22;42173
2020-05-24;Soria;Todos;Fisioterapeuta;4;1;0;1;42173
2020-05-24;Soria;Todos;Otros;0;0;0;0;42173
2020-05-24;Soria;Todos;Técnicos sanitarios;14;8;0;8;42173
2020-05-24;Valladolid;Todos;Administrativo;161;22;1;21;47186
2020-05-24;Valladolid;Todos;Médicos;643;100;2;98;47186
2020-05-24;Valladolid;Todos;Servicios de apoyo no sanitario;83;8;1;7;47186
2020-05-24;Zamora;Todos;Auxiliares sanitarios;53;5;1;4;49275
2020-05-24;Zamora;Todos;Enfermero/a;122;21;2;19;49275
2020-05-24;Zamora;Todos;Médicos;127;20;2;18;49275
2020-05-25;Ávila;Todos;Auxiliares sanitarios;228;42;25;17;5019
2020-05-25;Ávila;Todos;Servicios de apoyo no sanitario;29;8;6;2;5019
2020-05-25;Burgos;Todos;Administrativo;102;9;0;9;9059
2020-05-25;Burgos;Todos;Otros;4;1;1;0;9059
2020-05-25;Burgos;Todos;Otros sanitarios;18;0;0;0;9059
2020-05-25;Burgos;Todos;Servicios de apoyo no sanitario;47;4;1;3;9059
2020-05-25;León;Todos;Administrativo;173;9;1;8;24089
2020-05-25;León;Todos;Auxiliares sanitarios;669;58;4;54;24089
2020-05-25;León;Todos;Enfermero/a;1169;125;10;115;24089
2020-05-25;León;Todos;Médicos;687;80;2;78;24089
2020-05-25;León;Todos;Personal en formación;144;15;0;15;24089
2020-05-25;Palencia;Todos;Administrativo;21;4;1;3;34120
2020-05-25;Palencia;Todos;Celador;39;12;1;11;34120
2020-05-25;Palencia;Todos;Fisioterapeuta;5;2;0;2;34120
2020-05-25;Salamanca;Todos;Administrativo;84;20;5;15;37274
2020-05-25;Salamanca;Todos;Otros;6;2;0;2;37274
2020-05-25;Salamanca;Todos;Otros sanitarios;10;4;3;1;37274
2020-05-25;Salamanca;Todos;Técnicos sanitarios;49;16;1;15;37274
2020-05-25;Segovia;Todos;Auxiliares sanitarios;175;49;0;49;40004
2020-05-25;Segovia;Todos;Fisioterapeuta;4;1;0;1;40004
2020-05-25;Segovia;Todos;Otros;0;0;0;0;40004
2020-05-25;Segovia;Todos;Personal en formación;41;13;1;12;40004
2020-05-25;Soria;Todos;Enfermero/a;169;64;10;54;42173
2020-05-25;Soria;Todos;Fisioterapeuta;4;1;0;1;42173
2020-05-25;Soria;Todos;Otros;0;0;0;0;42173
2020-05-25;Soria;Todos;Servicios de apoyo no sanitario;15;2;0;2;42173
2020-05-25;Valladolid;Todos;Administrativo;163;22;1;21;47186
2020-05-25;Valladolid;Todos;Celador;133;23;3;20;47186
2020-05-25;Valladolid;Todos;Enfermero/a;953;151;10;141;47186
2020-05-25;Valladolid;Todos;Otros;5;0;0;0;47186
2020-05-25;Valladolid;Todos;Otros sanitarios;20;4;0;4;47186
2020-05-25;Valladolid;Todos;Técnicos sanitarios;101;9;0;9;47186
2020-05-25;Zamora;Todos;Enfermero/a;125;21;2;19;49275
2020-05-25;Zamora;Todos;Médicos;127;20;2;18;49275
2020-05-26;Ávila;Todos;Enfermero/a;399;85;56;29;5019
2020-05-26;Ávila;Todos;Otros;3;1;0;1;5019
2020-05-26;Ávila;Todos;Personal en formación;28;4;3;1;5019
2020-05-26;Ávila;Todos;Servicios de apoyo no sanitario;29;8;6;2;5019
2020-05-26;Ávila;Todos;Técnicos sanitarios;33;5;3;2;5019
2020-05-26;León;Todos;Auxiliares sanitarios;685;58;4;54;24089
2020-05-26;León;Todos;Celador;287;17;2;15;24089
2020-05-26;León;Todos;Médicos;693;80;2;78;24089
2020-05-26;Palencia;Todos;Administrativo;21;4;1;3;34120
2020-05-26;Palencia;Todos;Auxiliares sanitarios;100;21;5;16;34120
2020-05-26;Palencia;Todos;Enfermero/a;169;42;4;38;34120
2020-05-26;Palencia;Todos;Otros;4;1;1;0;34120
2020-05-26;Palencia;Todos;Otros sanitarios;6;1;0;1;34120
2020-05-26;Palencia;Todos;Servicios de apoyo no sanitario;15;3;0;3;34120
2020-05-26;Salamanca;Todos;Celador;103;23;2;21;37274
2020-05-26;Salamanca;Todos;Enfermero/a;502;120;22;98;37274
2020-05-26;Salamanca;Todos;Médicos;398;120;14;106;37274
2020-05-26;Salamanca;Todos;Otros;6;2;0;2;37274
2020-05-26;Segovia;Todos;Fisioterapeuta;4;1;0;1;40004
2020-05-26;Segovia;Todos;Médicos;251;75;8;67;40004
2020-05-26;Segovia;Todos;Servicios de apoyo no sanitario;29;10;1;9;40004
2020-05-26;Segovia;Todos;Técnicos sanitarios;34;13;0;13;40004
2020-05-26;Soria;Todos;Administrativo;45;14;4;10;42173
2020-05-26;Soria;Todos;Auxiliares sanitarios;92;26;2;24;42173
2020-05-26;Soria;Todos;Enfermero/a;169;64;10;54;42173
2020-05-26;Soria;Todos;Personal en formación;10;2;1;1;42173
2020-05-26;Valladolid;Todos;Auxiliares sanitarios;461;68;4;64;47186
2020-05-26;Valladolid;Todos;Celador;133;23;3;20;47186
2020-05-26;Valladolid;Todos;Enfermero/a;958;151;11;140;47186
2020-05-26;Valladolid;Todos;Fisioterapeuta;24;3;0;3;47186
2020-05-26;Valladolid;Todos;Médicos;648;100;1;99;47186
2020-05-26;Zamora;Todos;Administrativo;23;1;0;1;49275
2020-05-26;Zamora;Todos;Auxiliares sanitarios;53;5;1;4;49275
2020-05-26;Zamora;Todos;Enfermero/a;125;21;2;19;49275
2020-05-26;Zamora;Todos;Otros;0;0;0;0;49275
2020-05-26;Zamora;Todos;Otros sanitarios;6;1;1;0;49275
2020-05-27;Ávila;Todos;Celador;111;10;7;3;5019
2020-05-27;Ávila;Todos;Enfermero/a;399;85;56;29;5019
2020-05-27;Ávila;Todos;Otros;3;1;0;1;5019
2020-05-27;Ávila;Todos;Servicios de apoyo no sanitario;29;8;6;2;5019
2020-05-27;Burgos;Todos;Auxiliares sanitarios;582;52;9;43;9059
2020-05-27;Burgos;Todos;Enfermero/a;949;83;5;78;9059
2020-05-27;Burgos;Todos;Fisioterapeuta;18;2;0;2;9059
2020-05-27;Burgos;Todos;Médicos;490;57;6;51;9059
2020-05-27;Burgos;Todos;Otros sanitarios;18;0;0;0;9059
2020-05-27;Burgos;Todos;Servicios de apoyo no sanitario;48;4;0;4;9059
2020-05-27;Burgos;Todos;Técnicos sanitarios;92;5;0;5;9059
2020-05-27;León;Todos;Auxiliares sanitarios;708;59;4;55;24089
2020-05-27;León;Todos;Celador;296;17;2;15;24089
2020-05-27;León;Todos;Fisioterapeuta;40;2;0;2;24089
2020-05-27;León;Todos;Otros sanitarios;20;3;0;3;24089
2020-05-27;León;Todos;Técnicos sanitarios;190;7;1;6;24089
2020-05-27;Palencia;Todos;Administrativo;21;4;1;3;34120
2020-05-27;Palencia;Todos;Auxiliares sanitarios;100;21;6;15;34120
2020-05-27;Palencia;Todos;Otros;4;1;1;0;34120
2020-05-27;Salamanca;Todos;Administrativo;86;20;5;15;37274
2020-05-27;Salamanca;Todos;Otros;6;2;0;2;37274
2020-05-27;Salamanca;Todos;Otros sanitarios;10;4;2;2;37274
2020-05-27;Segovia;Todos;Celador;85;21;1;20;40004
2020-05-27;Segovia;Todos;Enfermero/a;346;122;2;120;40004
2020-05-27;Segovia;Todos;Otros sanitarios;6;1;1;0;40004
2020-05-27;Segovia;Todos;Personal en formación;41;13;1;12;40004
2020-05-27;Soria;Todos;Administrativo;46;14;3;11;42173
2020-05-27;Soria;Todos;Enfermero/a;169;64;10;54;42173
2020-05-27;Soria;Todos;Fisioterapeuta;4;1;0;1;42173
2020-05-27;Soria;Todos;Personal en formación;10;2;1;1;42173
2020-05-27;Soria;Todos;Servicios de apoyo no sanitario;16;2;0;2;42173
2020-05-27;Soria;Todos;Técnicos sanitarios;14;8;0;8;42173
2020-05-27;Valladolid;Todos;Administrativo;166;22;1;21;47186
2020-05-27;Valladolid;Todos;Médicos;649;100;1;99;47186
2020-05-27;Valladolid;Todos;Otros;6;0;0;0;47186
2020-05-27;Valladolid;Todos;Otros sanitarios;21;5;1;4;47186
2020-05-27;Valladolid;Todos;Personal en formación;141;22;0;22;47186
2020-05-27;Zamora;Todos;Administrativo;23;1;0;1;49275
2020-05-27;Zamora;Todos;Celador;31;3;0;3;49275
2020-05-27;Zamora;Todos;Otros;0;0;0;0;49275
2020-05-28;Ávila;Todos;Otros sanitarios;10;5;3;2;5019
2020-05-28;Burgos;Todos;Enfermero/a;955;83;5;78;9059
2020-05-28;Burgos;Todos;Otros;5;1;0;1;9059
2020-05-28;Burgos;Todos;Servicios de apoyo no sanitario;48;4;0;4;9059
2020-05-28;León;Todos;Administrativo;178;9;1;8;24089
2020-05-28;León;Todos;Auxiliares sanitarios;738;59;4;55;24089
2020-05-28;León;Todos;Celador;296;17;2;15;24089
2020-05-28;León;Todos;Médicos;710;81;3;78;24089
2020-05-28;León;Todos;Otros;6;0;0;0;24089
2020-05-28;León;Todos;Otros sanitarios;20;3;0;3;24089
2020-05-28;León;Todos;Técnicos sanitarios;190;7;1;6;24089
2020-05-28;Palencia;Todos;Servicios de apoyo no sanitario;19;3;0;3;34120
2020-05-28;Salamanca;Todos;Médicos;406;120;14;106;37274
2020-05-28;Salamanca;Todos;Otros;6;2;0;2;37274
2020-05-28;Salamanca;Todos;Técnicos sanitarios;50;16;1;15;37274
2020-05-28;Segovia;Todos;Administrativo;71;16;0;16;40004
2020-05-28;Segovia;Todos;Fisioterapeuta;4;1;0;1;40004
2020-05-28;Segovia;Todos;Médicos;251;75;8;67;40004
2020-05-28;Segovia;Todos;Servicios de apoyo no sanitario;30;10;0;10;40004
2020-05-28;Segovia;Todos;Técnicos sanitarios;34;13;0;13;40004
2020-05-28;Soria;Todos;Médicos;119;52;4;48;42173
2020-05-28;Soria;Todos;Otros;0;0;0;0;42173
2020-05-28;Soria;Todos;Personal en formación;10;2;1;1;42173
2020-05-28;Valladolid;Todos;Enfermero/a;963;151;9;142;47186
2020-05-28;Valladolid;Todos;Fisioterapeuta;24;3;0;3;47186
2020-05-28;Valladolid;Todos;Personal en formación;141;22;0;22;47186
2020-05-28;Valladolid;Todos;Servicios de apoyo no sanitario;85;8;1;7;47186
2020-05-28;Zamora;Todos;Administrativo;23;1;0;1;49275
2020-05-28;Zamora;Todos;Auxiliares sanitarios;54;5;0;5;49275
2020-05-28;Zamora;Todos;Celador;31;3;0;3;49275
2020-05-28;Zamora;Todos;Enfermero/a;126;21;2;19;49275
2020-05-28;Zamora;Todos;Médicos;128;20;2;18;49275
2020-05-28;Zamora;Todos;Servicios de apoyo no sanitario;5;0;0;0;49275
2020-05-29;Ávila;Todos;Auxiliares sanitarios;228;42;25;17;5019
2020-05-29;Ávila;Todos;Fisioterapeuta;8;0;0;0;5019
2020-05-29;Ávila;Todos;Otros;3;1;0;1;5019
2020-05-29;Burgos;Todos;Celador;153;15;0;15;9059
2020-05-29;Burgos;Todos;Enfermero/a;1007;83;4;79;9059
2020-05-29;Burgos;Todos;Fisioterapeuta;19;2;0;2;9059
2020-05-29;Burgos;Todos;Otros;5;1;0;1;9059
2020-05-29;Burgos;Todos;Técnicos sanitarios;93;5;0;5;9059
2020-05-29;León;Todos;Auxiliares sanitarios;787;60;5;55;24089
2020-05-29;León;Todos;Enfermero/a;1320;125;9;116;24089
2020-05-29;León;Todos;Fisioterapeuta;40;2;0;2;24089
2020-05-29;León;Todos;Personal en formación;154;15;0;15;24089
2020-05-29;León;Todos;Servicios de apoyo no sanitario;88;4;0;4;24089
2020-05-29;Palencia;Todos;Auxiliares sanitarios;101;21;6;15;34120
2020-05-29;Palencia;Todos;Enfermero/a;171;42;4;38;34120
2020-05-29;Palencia;Todos;Otros sanitarios;6;1;0;1;34120
2020-05-29;Palencia;Todos;Servicios de apoyo no sanitario;20;3;0;3;34120
2020-05-29;Palencia;Todos;Técnicos sanitarios;13;3;0;3;34120
2020-05-29;Salamanca;Todos;Fisioterapeuta;13;5;1;4;37274
2020-05-29;Salamanca;Todos;Otros sanitarios;10;4;2;2;37274
2020-05-29;Salamanca;Todos;Personal en formación;103;24;6;18;37274
2020-05-29;Salamanca;Todos;Técnicos sanitarios;50;16;1;15;37274
2020-05-29;Segovia;Todos;Administrativo;72;16;0;16;40004
2020-05-29;Segovia;Todos;Auxiliares sanitarios;175;49;0;49;40004
2020-05-29;Segovia;Todos;Fisioterapeuta;4;1;0;1;40004
2020-05-29;Segovia;Todos;Médicos;252;75;8;67;40004
2020-05-29;Segovia;Todos;Otros;0;0;0;0;40004
2020-05-29;Segovia;Todos;Servicios de apoyo no sanitario;30;10;0;10;40004
2020-05-29;Soria;Todos;Auxiliares sanitarios;96;26;2;24;42173
2020-05-29;Soria;Todos;Celador;27;9;0;9;42173
2020-05-29;Soria;Todos;Fisioterapeuta;4;1;0;1;42173
2020-05-29;Soria;Todos;Personal en formación;10;2;1;1;42173
2020-05-29;Soria;Todos;Servicios de apoyo no sanitario;16;2;0;2;42173
2020-05-29;Valladolid;Todos;Celador;134;23;3;20;47186
2020-05-29;Valladolid;Todos;Fisioterapeuta;24;3;0;3;47186
2020-05-29;Valladolid;Todos;Otros;6;0;0;0;47186
2020-05-29;Valladolid;Todos;Personal en formación;141;22;0;22;47186
2020-05-29;Valladolid;Todos;Técnicos sanitarios;101;9;0;9;47186
2020-05-29;Zamora;Todos;Celador;31;3;0;3;49275
2020-05-29;Zamora;Todos;Otros;0;0;0;0;49275
2020-05-29;Zamora;Todos;Técnicos sanitarios;12;0;0;0;49275
2020-05-30;Ávila;Todos;Administrativo;35;15;13;2;5019
2020-05-30;Ávila;Todos;Otros;3;1;0;1;5019
2020-05-30;Burgos;Todos;Auxiliares sanitarios;612;52;8;44;9059
2020-05-30;Burgos;Todos;Celador;153;15;0;15;9059
2020-05-30;Burgos;Todos;Fisioterapeuta;19;2;0;2;9059
2020-05-30;Burgos;Todos;Otros sanitarios;18;0;0;0;9059
2020-05-30;León;Todos;Auxiliares sanitarios;787;60;5;55;24089
2020-05-30;León;Todos;Otros;6;0;0;0;24089
2020-05-30;León;Todos;Personal en formación;154;15;0;15;24089
2020-05-30;León;Todos;Servicios de apoyo no sanitario;88;4;0;4;24089
2020-05-30;Palencia;Todos;Auxiliares sanitarios;101;21;6;15;34120
2020-05-30;Palencia;Todos;Celador;40;13;0;13;34120
2020-05-30;Palencia;Todos;Enfermero/a;172;42;4;38;34120
2020-05-30;Palencia;Todos;Otros;4;1;1;0;34120
2020-05-30;Palencia;Todos;Otros sanitarios;6;1;0;1;34120
2020-05-30;Palencia;Todos;Personal en formación;26;8;0;8;34120
2020-05-30;Palencia;Todos;Técnicos sanitarios;14;3;0;3;34120
2020-05-30;Salamanca;Todos;Administrativo;89;20;5;15;37274
2020-05-30;Salamanca;Todos;Auxiliares sanitarios;310;81;9;72;37274
2020-05-30;Salamanca;Todos;Celador;103;23;2;21;37274
2020-05-30;Salamanca;Todos;Fisioterapeuta;13;5;1;4;37274
2020-05-30;Salamanca;Todos;Técnicos sanitarios;50;16;1;15;37274
2020-05-30;Segovia;Todos;Enfermero/a;348;122;2;120;40004
2020-05-30;Segovia;Todos;Médicos;252;75;8;67;40004
2020-05-30;Segovia;Todos;Personal en formación;41;13;1;12;40004
2020-05-30;Segovia;Todos;Servicios de apoyo no sanitario;30;10;0;10;40004
2020-05-30;Soria;Todos;Auxiliares sanitarios;96;26;2;24;42173
2020-05-30;Soria;Todos;Celador;27;9;0;9;42173
2020-05-30;Valladolid;Todos;Administrativo;169;22;1;21;47186
2020-05-30;Valladolid;Todos;Enfermero/a;973;153;10;143;47186
2020-05-30;Valladolid;Todos;Fisioterapeuta;24;3;0;3;47186
2020-05-30;Valladolid;Todos;Otros;6;0;0;0;47186
2020-05-30;Valladolid;Todos;Personal en formación;142;22;0;22;47186
2020-05-30;Valladolid;Todos;Servicios de apoyo no sanitario;85;8;1;7;47186
2020-05-30;Zamora;Todos;Celador;31;3;0;3;49275
2020-05-31;Ávila;Todos;Administrativo;36;15;13;2;5019
2020-05-31;Ávila;Todos;Enfermero/a;400;85;54;31;5019
2020-05-31;Ávila;Todos;Fisioterapeuta;8;0;0;0;5019
2020-05-31;Ávila;Todos;Otros sanitarios;10;5;3;2;5019
2020-05-31;Ávila;Todos;Personal en formación;28;4;3;1;5019
2020-05-31;Ávila;Todos;Servicios de apoyo no sanitario;29;8;5;3;5019
2020-05-31;Burgos;Todos;Administrativo;109;9;0;9;9059
2020-05-31;Burgos;Todos;Auxiliares sanitarios;612;52;8;44;9059
2020-05-31;Burgos;Todos;Otros;5;1;0;1;9059
2020-05-31;Burgos;Todos;Otros sanitarios;18;0;0;0;9059
2020-05-31;León;Todos;Celador;296;17;2;15;24089
2020-05-31;Palencia;Todos;Administrativo;21;4;1;3;34120
2020-05-31;Palencia;Todos;Auxiliares sanitarios;102;21;6;15;34120
2020-05-31;Palencia;Todos;Celador;40;13;0;13;34120
2020-05-31;Palencia;Todos;Enfermero/a;172;42;4;38;34120
2020-05-31;Palencia;Todos;Fisioterapeuta;5;2;0;2;34120
2020-05-31;Palencia;Todos;Médicos;141;30;0;30;34120
2020-05-31;Salamanca;Todos;Enfermero/a;515;121;23;98;37274
2020-05-31;Salamanca;Todos;Médicos;409;120;14;106;37274
2020-05-31;Salamanca;Todos;Otros sanitarios;10;4;2;2;37274
2020-05-31;Salamanca;Todos;Servicios de apoyo no sanitario;65;12;1;11;37274
2020-05-31;Segovia;Todos;Enfermero/a;348;122;2;120;40004
2020-05-31;Segovia;Todos;Médicos;252;75;8;67;40004
2020-05-31;Segovia;Todos;Otros sanitarios;6;1;1;0;40004
2020-05-31;Segovia;Todos;Servicios de apoyo no sanitario;30;10;0;10;40004
2020-05-31;Soria;Todos;Celador;27;9;0;9;42173
2020-05-31;Soria;Todos;Enfermero/a;172;64;10;54;42173
2020-05-31;Soria;Todos;Fisioterapeuta;4;1;0;1;42173
2020-05-31;Valladolid;Todos;Auxiliares sanitarios;469;68;2;66;47186
2020-05-31;Zamora;Todos;Auxiliares sanitarios;54;5;0;5;49275
2020-05-31;Zamora;Todos;Celador;31;3;0;3;49275
2020-05-31;Zamora;Todos;Enfermero/a;128;21;2;19;49275
2020-05-31;Zamora;Todos;Médicos;130;20;2;18;49275
2020-05-31;Zamora;Todos;Otros sanitarios;6;1;0;1;49275
2020-05-31;Zamora;Todos;Técnicos sanitarios;13;0;0;0;49275
2020-06-01;Ávila;Todos;Auxiliares sanitarios;228;42;25;17;5019
2020-06-01;Ávila;Todos;Celador;111;10;7;3;5019
2020-06-01;Ávila;Todos;Fisioterapeuta;8;0;0;0;5019
2020-06-01;Ávila;Todos;Médicos;257;67;30;37;5019
2020-06-01;Ávila;Todos;Otros sanitarios;10;5;3;2;5019
2020-06-01;Ávila;Todos;Personal en formación;28;4;3;1;5019
2020-06-01;Ávila;Todos;Técnicos sanitarios;34;5;3;2;5019
2020-06-01;Burgos;Todos;Administrativo;109;9;0;9;9059
2020-06-01;Burgos;Todos;Técnicos sanitarios;98;5;0;5;9059
2020-06-01;León;Todos;Celador;298;17;1;16;24089
2020-06-01;León;Todos;Enfermero/a;1375;125;9;116;24089
2020-06-01;León;Todos;Médicos;722;80;3;77;24089
2020-06-01;León;Todos;Otros;7;0;0;0;24089
2020-06-01;León;Todos;Personal en formación;157;15;0;15;24089
2020-06-01;Palencia;Todos;Médicos;142;30;0;30;34120
2020-06-01;Palencia;Todos;Otros;4;1;1;0;34120
2020-06-01;Palencia;Todos;Servicios de apoyo no sanitario;20;3;0;3;34120
2020-06-01;Salamanca;Todos;Auxiliares sanitarios;310;81;9;72;37274
2020-06-01;Salamanca;Todos;Celador;103;23;2;21;37274
2020-06-01;Salamanca;Todos;Otros;7;2;0;2;37274
2020-06-01;Salamanca;Todos;Personal en formación;103;24;6;18;37274
2020-06-01;Salamanca;Todos;Técnicos sanitarios;51;16;1;15;37274
2020-06-01;Segovia;Todos;Celador;85;21;1;20;40004
2020-06-01;Segovia;Todos;Enfermero/a;348;122;2;120;40004
2020-06-01;Segovia;Todos;Médicos;252;75;8;67;40004
2020-06-01;Segovia;Todos;Otros;0;0;0;0;40004
2020-06-01;Segovia;Todos;Personal en formación;42;13;1;12;40004
2020-06-01;Segovia;Todos;Servicios de apoyo no sanitario;31;10;0;10;40004
2020-06-01;Soria;Todos;Auxiliares sanitarios;96;26;2;24;42173
2020-06-01;Soria;Todos;Servicios de apoyo no sanitario;17;3;1;2;42173
2020-06-01;Soria;Todos;Técnicos sanitarios;15;8;0;8;42173
2020-06-01;Valladolid;Todos;Fisioterapeuta;24;3;0;3;47186
2020-06-01;Valladolid;Todos;Otros;6;0;0;0;47186
2020-06-01;Valladolid;Todos;Otros sanitarios;21;5;1;4;47186
2020-06-01;Valladolid;Todos;Personal en formación;142;22;0;22;47186
2020-06-01;Valladolid;Todos;Servicios de apoyo no sanitario;88;8;1;7;47186
2020-06-01;Zamora;Todos;Enfermero/a;128;21;2;19;49275
2020-06-01;Zamora;Todos;Médicos;131;20;2;18;49275
2020-06-01;Zamora;Todos;Otros;0;0;0;0;49275
2020-06-02;Ávila;Todos;Administrativo;36;15;13;2;5019
2020-06-02;Ávila;Todos;Auxiliares sanitarios;227;42;23;19;5019
2020-06-02;Ávila;Todos;Enfermero/a;399;83;51;32;5019
2020-06-02;Ávila;Todos;Médicos;257;67;30;37;5019
2020-06-02;Ávila;Todos;Otros;3;1;0;1;5019
2020-06-02;Burgos;Todos;Administrativo;111;9;0;9;9059
2020-06-02;Burgos;Todos;Auxiliares sanitarios;681;52;5;47;9059
2020-06-02;Burgos;Todos;Enfermero/a;1111;83;3;80;9059
2020-06-02;Burgos;Todos;Fisioterapeuta;20;2;0;2;9059
2020-06-02;Burgos;Todos;Otros sanitarios;18;0;0;0;9059
2020-06-02;León;Todos;Auxiliares sanitarios;866;60;5;55;24089
2020-06-02;León;Todos;Personal en formación;171;15;0;15;24089
2020-06-02;León;Todos;Servicios de apoyo no sanitario;106;4;0;4;24089
2020-06-02;Palencia;Todos;Auxiliares sanitarios;103;21;4;17;34120
2020-06-02;Palencia;Todos;Fisioterapeuta;5;2;0;2;34120
2020-06-02;Salamanca;Todos;Auxiliares sanitarios;312;81;9;72;37274
2020-06-02;Salamanca;Todos;Fisioterapeuta;13;5;1;4;37274
2020-06-02;Salamanca;Todos;Médicos;411;120;13;107;37274
2020-06-02;Salamanca;Todos;Otros;7;2;0;2;37274
2020-06-02;Salamanca;Todos;Servicios de apoyo no sanitario;68;12;1;11;37274
2020-06-02;Salamanca;Todos;Técnicos sanitarios;52;16;1;15;37274
2020-06-02;Segovia;Todos;Administrativo;72;16;0;16;40004
2020-06-02;Segovia;Todos;Enfermero/a;349;122;2;120;40004
2020-06-02;Segovia;Todos;Médicos;252;75;8;67;40004
2020-06-02;Segovia;Todos;Otros;0;0;0;0;40004
2020-06-02;Segovia;Todos;Personal en formación;42;13;1;12;40004
2020-06-02;Soria;Todos;Enfermero/a;174;66;12;54;42173
2020-06-02;Soria;Todos;Médicos;123;53;5;48;42173
2020-06-02;Soria;Todos;Otros sanitarios;5;2;0;2;42173
2020-06-02;Soria;Todos;Servicios de apoyo no sanitario;17;3;1;2;42173
2020-06-02;Soria;Todos;Técnicos sanitarios;15;8;0;8;42173
2020-06-02;Valladolid;Todos;Auxiliares sanitarios;472;68;1;67;47186
2020-06-02;Valladolid;Todos;Celador;137;23;3;20;47186
2020-06-02;Valladolid;Todos;Enfermero/a;978;153;8;145;47186
2020-06-02;Valladolid;Todos;Fisioterapeuta;25;3;0;3;47186
2020-06-02;Valladolid;Todos;Otros;6;0;0;0;47186
2020-06-02;Zamora;Todos;Fisioterapeuta;4;0;0;0;49275
2020-06-02;Zamora;Todos;Otros;0;0;0;0;49275
2020-06-02;Zamora;Todos;Personal en formación;8;0;0;0;49275
2020-06-02;Zamora;Todos;Servicios de apoyo no sanitario;5;0;0;0;49275
2020-06-03;Ávila;Todos;Administrativo;36;15;13;2;5019
2020-06-03;Ávila;Todos;Médicos;257;67;30;37;5019
2020-06-03;Burgos;Todos;Auxiliares sanitarios;722;52;3;49;9059
2020-06-03;Burgos;Todos;Celador;189;15;1;14;9059
2020-06-03;Burgos;Todos;Fisioterapeuta;20;2;0;2;9059
2020-06-03;Burgos;Todos;Técnicos sanitarios;100;5;0;5;9059
2020-06-03;León;Todos;Celador;301;17;1;16;24089
2020-06-03;León;Todos;Fisioterapeuta;43;2;0;2;24089
2020-06-03;León;Todos;Servicios de apoyo no sanitario;117;4;0;4;24089
2020-06-03;León;Todos;Técnicos sanitarios;216;7;1;6;24089
2020-06-03;Palencia;Todos;Administrativo;21;4;1;3;34120
2020-06-03;Palencia;Todos;Técnicos sanitarios;15;3;0;3;34120
2020-06-03;Salamanca;Todos;Auxiliares sanitarios;315;82;10;72;37274
2020-06-03;Salamanca;Todos;Enfermero/a;529;121;20;101;37274
2020-06-03;Salamanca;Todos;Médicos;411;120;13;107;37274
2020-06-03;Salamanca;Todos;Personal en formación;103;24;6;18;37274
2020-06-03;Segovia;Todos;Auxiliares sanitarios;176;49;0;49;40004
2020-06-03;Segovia;Todos;Otros;0;0;0;0;40004
2020-06-03;Segovia;Todos;Personal en formación;43;13;1;12;40004
2020-06-03;Soria;Todos;Administrativo;47;14;4;10;42173
2020-06-03;Soria;Todos;Otros sanitarios;5;2;0;2;42173
2020-06-03;Valladolid;Todos;Administrativo;170;22;1;21;47186
2020-06-03;Valladolid;Todos;Celador;137;23;3;20;47186
2020-06-03;Valladolid;Todos;Enfermero/a;982;153;8;145;47186
2020-06-03;Valladolid;Todos;Personal en formación;143;22;0;22;47186
2020-06-03;Valladolid;Todos;Servicios de apoyo no sanitario;90;8;1;7;47186
2020-06-03;Zamora;Todos;Auxiliares sanitarios;56;5;0;5;49275
2020-06-03;Zamora;Todos;Fisioterapeuta;4;0;0;0;49275
2020-06-03;Zamora;Todos;Médicos;132;20;2;18;49275
2020-06-03;Zamora;Todos;Otros sanitarios;6;1;0;1;49275
2020-06-03;Zamora;Todos;Personal en formación;8;0;0;0;49275
2020-06-03;Zamora;Todos;Servicios de apoyo no sanitario;5;0;0;0;49275
2020-06-04;Ávila;Todos;Administrativo;36;15;13;2;5019
2020-06-04;Ávila;Todos;Auxiliares sanitarios;227;42;23;19;5019
2020-06-04;Ávila;Todos;Otros;3;1;0;1;5019
2020-06-04;Ávila;Todos;Otros sanitarios;10;5;3;2;5019
2020-06-04;Burgos;Todos;Auxiliares sanitarios;734;51;2;49;9059
2020-06-04;Burgos;Todos;Celador;207;15;1;14;9059
2020-06-04;Burgos;Todos;Fisioterapeuta;20;2;0;2;9059
2020-06-04;Burgos;Todos;Médicos;697;58;7;51;9059
2020-06-04;Burgos;Todos;Personal en formación;134;6;1;5;9059
2020-06-04;León;Todos;Fisioterapeuta;43;2;0;2;24089
2020-06-04;León;Todos;Otros sanitarios;26;3;0;3;24089
2020-06-04;Palencia;Todos;Auxiliares sanitarios;105;21;2;19;34120
2020-06-04;Palencia;Todos;Médicos;147;30;0;30;34120
2020-06-04;Palencia;Todos;Otros;4;1;1;0;34120
2020-06-04;Palencia;Todos;Otros sanitarios;6;1;0;1;34120
2020-06-04;Salamanca;Todos;Administrativo;92;20;3;17;37274
2020-06-04;Salamanca;Todos;Personal en formación;103;24;6;18;37274
2020-06-04;Segovia;Todos;Fisioterapeuta;4;1;0;1;40004
2020-06-04;Segovia;Todos;Otros;0;0;0;0;40004
2020-06-04;Soria;Todos;Médicos;125;53;5;48;42173
2020-06-04;Soria;Todos;Otros;0;0;0;0;42173
2020-06-04;Soria;Todos;Otros sanitarios;5;2;0;2;42173
2020-06-04;Soria;Todos;Personal en formación;10;2;1;1;42173
2020-06-04;Soria;Todos;Técnicos sanitarios;15;8;0;8;42173
2020-06-04;Valladolid;Todos;Auxiliares sanitarios;473;68;1;67;47186
2020-06-04;Valladolid;Todos;Médicos;664;100;1;99;47186
2020-06-04;Valladolid;Todos;Otros;6;0;0;0;47186
2020-06-04;Valladolid;Todos;Otros sanitarios;21;5;0;5;47186
2020-06-04;Zamora;Todos;Administrativo;23;1;0;1;49275
2020-06-04;Zamora;Todos;Celador;31;3;0;3;49275
2020-06-04;Zamora;Todos;Médicos;131;19;1;18;49275
2020-06-04;Zamora;Todos;Otros;0;0;0;0;49275
2020-06-04;Zamora;Todos;Personal en formación;8;0;0;0;49275
2020-06-05;Ávila;Todos;Auxiliares sanitarios;227;42;23;19;5019
2020-06-05;Ávila;Todos;Celador;110;9;5;4;5019
2020-06-05;Ávila;Todos;Fisioterapeuta;8;0;0;0;5019
2020-06-05;Ávila;Todos;Personal en formación;28;4;3;1;5019
2020-06-05;Ávila;Todos;Técnicos sanitarios;35;5;3;2;5019
2020-06-05;Burgos;Todos;Fisioterapeuta;20;2;0;2;9059
2020-06-05;Burgos;Todos;Otros;5;1;0;1;9059
2020-06-05;Burgos;Todos;Otros sanitarios;20;0;0;0;9059
2020-06-05;Burgos;Todos;Personal en formación;146;6;1;5;9059
2020-06-05;León;Todos;Fisioterapeuta;43;2;0;2;24089
2020-06-05;Palencia;Todos;Administrativo;22;4;1;3;34120
2020-06-05;Palencia;Todos;Otros sanitarios;6;1;0;1;34120
2020-06-05;Salamanca;Todos;Auxiliares sanitarios;316;82;10;72;37274
2020-06-05;Salamanca;Todos;Celador;110;24;3;21;37274
2020-06-05;Salamanca;Todos;Enfermero/a;529;121;20;101;37274
2020-06-05;Salamanca;Todos;Médicos;412;120;13;107;37274
2020-06-05;Segovia;Todos;Administrativo;72;16;0;16;40004
2020-06-05;Segovia;Todos;Servicios de apoyo no sanitario;32;10;0;10;40004
2020-06-05;Segovia;Todos;Técnicos sanitarios;36;13;0;13;40004
2020-06-05;Soria;Todos;Médicos;125;53;6;47;42173
2020-06-05;Soria;Todos;Otros;0;0;0;0;42173
2020-06-05;Soria;Todos;Personal en formación;10;2;1;1;42173
2020-06-05;Valladolid;Todos;Médicos;664;100;1;99;47186
2020-06-05;Valladolid;Todos;Otros;6;0;0;0;47186
2020-06-05;Zamora;Todos;Celador;31;3;0;3;49275
2020-06-05;Zamora;Todos;Enfermero/a;130;21;2;19;49275
2020-06-05;Zamora;Todos;Fisioterapeuta;4;0;0;0;49275
2020-06-05;Zamora;Todos;Otros;0;0;0;0;49275
2020-06-05;Zamora;Todos;Servicios de apoyo no sanitario;5;0;0;0;49275
2020-06-05;Zamora;Todos;Técnicos sanitarios;13;0;0;0;49275
2020-06-06;Ávila;Todos;Enfermero/a;402;83;50;33;5019
2020-06-06;Ávila;Todos;Fisioterapeuta;8;0;0;0;5019
2020-06-06;Ávila;Todos;Personal en formación;28;4;3;1;5019
2020-06-06;Ávila;Todos;Técnicos sanitarios;36;5;3;2;5019
2020-06-06;Burgos;Todos;Médicos;712;58;7;51;9059
2020-06-06;Burgos;Todos;Otros;5;1;0;1;9059
2020-06-06;Burgos;Todos;Personal en formación;148;6;1;5;9059
2020-06-06;León;Todos;Administrativo;317;9;1;8;24089
2020-06-06;León;Todos;Enfermero/a;1495;126;7;119;24089
2020-06-06;León;Todos;Médicos;840;81;4;77;24089
2020-06-06;León;Todos;Otros;8;0;0;0;24089
2020-06-06;León;Todos;Personal en formación;171;15;0;15;24089
2020-06-06;Palencia;Todos;Enfermero/a;180;42;4;38;34120
2020-06-06;Palencia;Todos;Otros sanitarios;6;1;0;1;34120
2020-06-06;Palencia;Todos;Servicios de apoyo no sanitario;21;4;1;3;34120
2020-06-06;Salamanca;Todos;Enfermero/a;531;121;20;101;37274
2020-06-06;Salamanca;Todos;Otros;7;2;0;2;37274
2020-06-06;Segovia;Todos;Celador;86;21;1;20;40004
2020-06-06;Segovia;Todos;Fisioterapeuta;4;1;0;1;40004
2020-06-06;Segovia;Todos;Otros sanitarios;6;1;1;0;40004
2020-06-06;Soria;Todos;Administrativo;48;15;5;10;42173
2020-06-06;Soria;Todos;Enfermero/a;179;67;12;55;42173
2020-06-06;Soria;Todos;Médicos;125;53;6;47;42173
2020-06-06;Soria;Todos;Otros sanitarios;5;2;0;2;42173
2020-06-06;Soria;Todos;Servicios de apoyo no sanitario;18;3;1;2;42173
2020-06-06;Valladolid;Todos;Otros;6;0;0;0;47186
2020-06-06;Valladolid;Todos;Otros sanitarios;21;5;0;5;47186
2020-06-06;Valladolid;Todos;Servicios de apoyo no sanitario;91;8;1;7;47186
2020-06-06;Zamora;Todos;Administrativo;23;1;0;1;49275
2020-06-06;Zamora;Todos;Auxiliares sanitarios;57;5;0;5;49275
2020-06-06;Zamora;Todos;Médicos;132;20;1;19;49275
2020-06-06;Zamora;Todos;Otros;0;0;0;0;49275
2020-06-06;Zamora;Todos;Personal en formación;8;0;0;0;49275
2020-06-06;Zamora;Todos;Servicios de apoyo no sanitario;5;0;0;0;49275
2020-06-07;Ávila;Todos;Administrativo;36;15;13;2;5019
2020-06-07;Ávila;Todos;Auxiliares sanitarios;227;42;23;19;5019
2020-06-07;Ávila;Todos;Celador;111;9;5;4;5019
2020-06-07;Ávila;Todos;Fisioterapeuta;8;0;0;0;5019
2020-06-07;Ávila;Todos;Médicos;258;67;30;37;5019
2020-06-07;Ávila;Todos;Personal en formación;28;4;3;1;5019
2020-06-07;Ávila;Todos;Técnicos sanitarios;36;5;3;2;5019
2020-06-07;Burgos;Todos;Auxiliares sanitarios;779;51;2;49;9059
2020-06-07;Burgos;Todos;Técnicos sanitarios;129;5;0;5;9059
2020-06-07;León;Todos;Auxiliares sanitarios;922;61;4;57;24089
2020-06-07;León;Todos;Médicos;841;81;4;77;24089
2020-06-07;León;Todos;Servicios de apoyo no sanitario;158;4;0;4;24089
2020-06-07;León;Todos;Técnicos sanitarios;221;7;0;7;24089
2020-06-07;Palencia;Todos;Personal en formación;27;8;0;8;34120
2020-06-07;Salamanca;Todos;Otros;8;2;0;2;37274
2020-06-07;Salamanca;Todos;Técnicos sanitarios;53;16;1;15;37274
2020-06-07;Segovia;Todos;Administrativo;72;16;0;16;40004
2020-06-07;Segovia;Todos;Enfermero/a;352;122;2;120;40004
2020-06-07;Segovia;Todos;Otros sanitarios;6;1;1;0;40004
2020-06-07;Segovia;Todos;Técnicos sanitarios;36;13;0;13;40004
2020-06-07;Soria;Todos;Administrativo;47;15;5;10;42173
2020-06-07;Soria;Todos;Enfermero/a;179;67;12;55;42173
2020-06-07;Soria;Todos;Médicos;125;53;6;47;42173
2020-06-07;Soria;Todos;Otros;0;0;0;0;42173
2020-06-07;Soria;Todos;Otros sanitarios;5;2;0;2;42173
2020-06-07;Soria;Todos;Servicios de apoyo no sanitario;19;3;1;2;42173
2020-06-07;Valladolid;Todos;Auxiliares sanitarios;475;69;2;67;47186
2020-06-07;Valladolid;Todos;Servicios de apoyo no sanitario;91;8;1;7;47186
2020-06-07;Zamora;Todos;Celador;31;3;0;3;49275
2020-06-07;Zamora;Todos;Fisioterapeuta;4;0;0;0;49275
2020-06-07;Zamora;Todos;Médicos;132;20;1;19;49275
2020-06-07;Zamora;Todos;Otros sanitarios;6;1;0;1;49275
2020-06-07;Zamora;Todos;Personal en formación;8;0;0;0;49275
2020-06-08;Ávila;Emergencias sanitarias;Otros;0;0;0;0;5019
2020-06-08;Ávila;Emergencias sanitarias;Personal en formación;0;0;0;0;5019
2020-06-08;Ávila;Especializada;Administrativo;21;14;7;7;5019
2020-06-08;Ávila;Especializada;Celador;112;25;5;20;5019
2020-06-08;Ávila;Especializada;Enfermero/a;332;96;38;58;5019
2020-06-08;Ávila;Especializada;Otros sanitarios;6;6;2;4;5019
2020-06-08;Ávila;Primaria;Administrativo;16;10;6;4;5019
2020-06-08;Ávila;Primaria;Celador;3;1;0;1;5019
2020-06-08;Ávila;Primaria;Enfermero/a;83;31;12;19;5019
2020-06-08;Ávila;Primaria;Médicos;101;38;15;23;5019
2020-06-08;Ávila;Primaria;Otros;0;0;0;0;5019
2020-06-08;Ávila;Primaria;Personal en formación;21;4;3;1;5019
2020-06-08;Ávila;Primaria;Servicios de apoyo no sanitarios;0;0;0;0;5019
2020-06-08;Ávila;Primaria;Técnicos sanitarios;1;0;0;0;5019
2020-06-08;Ávila;Servicios centrales GRS;Médicos;0;0;0;0;5019
2020-06-08;Ávila;Servicios centrales GRS;Otros;0;0;0;0;5019
2020-06-08;Ávila;Servicios centrales GRS;Servicios de apoyo no sanitarios;0;0;0;0;5019
2020-06-08;Ávila;Servicios centrales GRS;Técnicos sanitarios;0;0;0;0;5019
2020-06-08;Burgos;Emergencias sanitarias;Administrativo;0;0;0;0;9059
2020-06-08;Burgos;Emergencias sanitarias;Enfermero/a;0;0;0;0;9059
2020-06-08;Burgos;Emergencias sanitarias;Personal en formación;0;0;0;0;9059
2020-06-08;Burgos;Especializada;Administrativo;110;18;0;18;9059
2020-06-08;Burgos;Especializada;Fisioterapeuta;17;3;0;3;9059
2020-06-08;Burgos;Especializada;Otros;5;1;0;1;9059
2020-06-08;Burgos;Primaria;Fisioterapeuta;3;0;0;0;9059
2020-06-08;Burgos;Primaria;Personal en formación;9;2;0;2;9059
2020-06-08;Burgos;Primaria;Servicios de apoyo no sanitarios;2;0;0;0;9059
2020-06-08;Burgos;Servicios centrales GRS;Auxiliares sanitarios;0;0;0;0;9059
2020-06-08;Burgos;Servicios centrales GRS;Celador;0;0;0;0;9059
2020-06-08;Burgos;Servicios centrales GRS;Enfermero/a;0;0;0;0;9059
2020-06-08;Burgos;Servicios centrales GRS;Técnicos sanitarios;0;0;0;0;9059
2020-06-08;León;Emergencias sanitarias;Administrativo;0;0;0;0;24089
2020-06-08;León;Emergencias sanitarias;Auxiliares sanitarios;0;0;0;0;24089
2020-06-08;León;Emergencias sanitarias;Otros;0;0;0;0;24089
2020-06-08;León;Emergencias sanitarias;Otros sanitarios;0;0;0;0;24089
2020-06-08;León;Especializada;Médicos;665;96;4;92;24089
2020-06-08;León;Especializada;Otros;7;0;0;0;24089
2020-06-08;León;Especializada;Otros sanitarios;20;4;0;4;24089
2020-06-08;León;Primaria;Auxiliares sanitarios;20;10;0;10;24089
2020-06-08;León;Primaria;Otros sanitarios;8;1;0;1;24089
2020-06-08;León;Servicios centrales GRS;Personal en formación;0;0;0;0;24089
2020-06-08;León;Servicios centrales GRS;Técnicos sanitarios;0;0;0;0;24089
2020-06-08;Palencia;Emergencias sanitarias;Fisioterapeuta;0;0;0;0;34120
2020-06-08;Palencia;Emergencias sanitarias;Otros sanitarios;0;0;0;0;34120
2020-06-08;Palencia;Emergencias sanitarias;Personal en formación;0;0;0;0;34120
2020-06-08;Palencia;Especializada;Administrativo;8;1;0;1;34120
2020-06-08;Palencia;Especializada;Auxiliares sanitarios;99;21;1;20;34120
2020-06-08;Palencia;Especializada;Enfermero/a;119;29;1;28;34120
2020-06-08;Palencia;Especializada;Otros;4;1;1;0;34120
2020-06-08;Palencia;Primaria;Administrativo;14;10;1;9;34120
2020-06-08;Palencia;Primaria;Médicos;65;18;0;18;34120
2020-06-08;Palencia;Primaria;Otros;0;0;0;0;34120
2020-06-08;Palencia;Servicios centrales GRS;Auxiliares sanitarios;0;0;0;0;34120
2020-06-08;Palencia;Servicios centrales GRS;Fisioterapeuta;0;0;0;0;34120
2020-06-08;Palencia;Servicios centrales GRS;Médicos;0;0;0;0;34120
2020-06-08;Palencia;Servicios centrales GRS;Personal en formación;0;0;0;0;34120
2020-06-08;Salamanca;Emergencias sanitarias;Celador;0;0;0;0;37274
2020-06-08;Salamanca;Emergencias sanitarias;Fisioterapeuta;0;0;0;0;37274
2020-06-08;Salamanca;Emergencias sanitarias;Médicos;0;0;0;0;37274
2020-06-08;Salamanca;Emergencias sanitarias;Otros sanitarios;0;0;0;0;37274
2020-06-08;Salamanca;Especializada;Fisioterapeuta;11;5;0;5;37274
2020-06-08;Salamanca;Especializada;Personal en formación;90;31;5;26;37274
2020-06-08;Salamanca;Primaria;Administrativo;24;10;2;8;37274
2020-06-08;Salamanca;Primaria;Celador;7;3;0;3;37274
2020-06-08;Salamanca;Primaria;Enfermero/a;112;36;0;36;37274
2020-06-08;Salamanca;Primaria;Otros sanitarios;2;2;1;1;37274
2020-06-08;Salamanca;Servicios centrales GRS;Enfermero/a;0;0;0;0;37274
2020-06-08;Salamanca;Servicios centrales GRS;Fisioterapeuta;0;0;0;0;37274
2020-06-08;Salamanca;Servicios centrales GRS;Otros;0;0;0;0;37274
2020-06-08;Salamanca;Servicios centrales GRS;Servicios de apoyo no sanitarios;0;0;0;0;37274
2020-06-08;Segovia;Emergencias sanitarias;Otros sanitarios;0;0;0;0;40004
2020-06-08;Segovia;Emergencias sanitarias;Técnicos sanitarios;0;0;0;0;40004
2020-06-08;Segovia;Especializada;Fisioterapeuta;1;0;0;0;40004
2020-06-08;Segovia;Especializada;Técnicos sanitarios;34;15;0;15;40004
2020-06-08;Segovia;Primaria;Administrativo;26;15;0;15;40004
2020-06-08;Segovia;Primaria;Auxiliares sanitarios;7;4;0;4;40004
2020-06-08;Segovia;Primaria;Enfermero/a;94;60;0;60;40004
2020-06-08;Segovia;Primaria;Fisioterapeuta;3;1;0;1;40004
2020-06-08;Segovia;Primaria;Médicos;105;57;2;55;40004
2020-06-08;Segovia;Servicios centrales GRS;Auxiliares sanitarios;0;0;0;0;40004
2020-06-08;Segovia;Servicios centrales GRS;Celador;0;0;0;0;40004
2020-06-08;Segovia;Servicios centrales GRS;Médicos;0;0;0;0;40004
2020-06-08;Segovia;Servicios centrales GRS;Otros;0;0;0;0;40004
2020-06-08;Segovia;Servicios centrales GRS;Personal en formación;0;0;0;0;40004
2020-06-08;Segovia;Servicios centrales GRS;Técnicos sanitarios;0;0;0;0;40004
2020-06-08;Soria;Emergencias sanitarias;Enfermero/a;0;0;0;0;42173
2020-06-08;Soria;Emergencias sanitarias;Fisioterapeuta;0;0;0;0;42173
2020-06-08;Soria;Emergencias sanitarias;Médicos;0;0;0;0;42173
2020-06-08;Soria;Emergencias sanitarias;Otros;0;0;0;0;42173
2020-06-08;Soria;Especializada;Administrativo;27;22;3;19;42173
2020-06-08;Soria;Especializada;Auxiliares sanitarios;96;60;1;59;42173
2020-06-08;Soria;Especializada;Médicos;68;43;4;39;42173
2020-06-08;Soria;Primaria;Enfermero/a;51;33;4;29;42173
2020-06-08;Soria;Primaria;Otros;0;0;0;0;42173
2020-06-08;Soria;Primaria;Otros sanitarios;3;1;0;1;42173
2020-06-08;Soria;Servicios centrales GRS;Administrativo;0;0;0;0;42173
2020-06-08;Soria;Servicios centrales GRS;Enfermero/a;0;0;0;0;42173
2020-06-08;Soria;Servicios centrales GRS;Médicos;0;0;0;0;42173
2020-06-08;Soria;Servicios centrales GRS;Otros sanitarios;0;0;0;0;42173
2020-06-08;Soria;Servicios centrales GRS;Servicios de apoyo no sanitarios;0;0;0;0;42173
2020-06-08;Valladolid;Emergencias sanitarias;Médicos;68;23;0;23;47186
2020-06-08;Valladolid;Emergencias sanitarias;Otros;0;0;0;0;47186
2020-06-08;Valladolid;Emergencias sanitarias;Personal en formación;0;0;0;0;47186
2020-06-08;Valladolid;Emergencias sanitarias;Técnicos sanitarios;0;0;0;0;47186
2020-06-08;Valladolid;Especializada;Administrativo;107;44;0;44;47186
2020-06-08;Valladolid;Especializada;Auxiliares sanitarios;464;122;2;120;47186
2020-06-08;Valladolid;Especializada;Médicos;406;120;1;119;47186
2020-06-08;Valladolid;Primaria;Administrativo;55;17;1;16;47186
2020-06-08;Valladolid;Primaria;Enfermero/a;143;39;0;39;47186
2020-06-08;Valladolid;Primaria;Fisioterapeuta;7;3;0;3;47186
2020-06-08;Valladolid;Primaria;Otros sanitarios;7;2;0;2;47186
2020-06-08;Valladolid;Primaria;Servicios de apoyo no sanitarios;1;0;0;0;47186
2020-06-08;Valladolid;Primaria;Técnicos sanitarios;6;0;0;0;47186
2020-06-08;Valladolid;Servicios centrales GRS;Administrativo;5;3;0;3;47186
2020-06-08;Valladolid;Servicios centrales GRS;Enfermero/a;0;0;0;0;47186
2020-06-08;Valladolid;Servicios centrales GRS;Médicos;6;0;0;0;47186
2020-06-08;Valladolid;Servicios centrales GRS;Personal en formación;0;0;0;0;47186
2020-06-08;Zamora;Emergencias sanitarias;Auxiliares sanitarios;0;0;0;0;49275
2020-06-08;Zamora;Emergencias sanitarias;Fisioterapeuta;0;0;0;0;49275
2020-06-08;Zamora;Emergencias sanitarias;Técnicos sanitarios;0;0;0;0;49275
2020-06-08;Zamora;Especializada;Fisioterapeuta;2;1;0;1;49275
2020-06-08;Zamora;Especializada;Técnicos sanitarios;13;3;0;3;49275
2020-06-08;Zamora;Primaria;Médicos;60;19;0;19;49275
2020-06-08;Zamora;Primaria;Otros;0;0;0;0;49275
2020-06-08;Zamora;Primaria;Personal en formación;3;2;0;2;49275
2020-06-08;Zamora;Primaria;Técnicos sanitarios;1;1;0;1;49275
2020-06-08;Zamora;Servicios centrales GRS;Administrativo;0;0;0;0;49275
2020-06-08;Zamora;Servicios centrales GRS;Enfermero/a;0;0;0;0;49275
2020-06-08;Zamora;Servicios centrales GRS;Otros sanitarios;0;0;0;0;49275
